Ri numam xkamik are taq kʼo jumuchʼ lajuj ujunabʼ .	Ri nu>mam x>kamik are taq kʼo jumuchʼ lajuj u>junabʼ .
Nojel qʼij ri a Tiʼx kuyuqʼuj le taq awaj jelaʼ pa nikʼaj jaʼ , chirij ri juyubʼ ubʼiʼ Tenaʼ .	Nojel qʼij ri a Tiʼx k>u>yuqʼuj le taq awaj jelaʼ pa nikʼaj jaʼ , chi>r>ij ri juyubʼ u>bʼiʼ Tenaʼ .
Kateʼbʼin .	K>at>eʼ>bʼin .
Entonses are kʼwaʼ le kawaj kinbʼij pan in .	Entonses are kʼ>waʼ le k>aw>aj k>in>bʼij pan in .
Nim raqan le cheʼ .	Nim r>aqan le cheʼ .
Chweʼq kinchakun pa qʼij chi chaqʼabʼ .	Chweʼq k>in>chakun pa qʼij chi chaqʼabʼ .
Jeʼ , kimbʼek .	Jeʼ , k>im>bʼe>k .
Ri imul xuchʼij taj , xkanaj pa bʼe , rumal ri nimal kujaluj ri imul , xutzaq ri anim .	Ri imul x>u>chʼij taj , x>kanaj pa bʼe , r>umal ri nimal k>u>jaluj ri imul , x>u>tzaq ri anim .
Ri ukis akʼ utz kyaʼik chi uxeʼ ri tikoʼn .	Ri u>kis akʼ utz k>yaʼ>ik chi u>xeʼ ri tikoʼn .
Chweʼq kinbʼe pa nim tinamit .	Chweʼq k>in>bʼe pa nim tinamit .
Sibʼalaj kʼokʼ ri awatzʼyaq .	Sibʼalaj kʼokʼ ri aw>atzʼyaq .
Talom ri uchiʼ ja .	Talom ri u>chiʼ ja .
Xinpetik , na xinwil taj .	X>in>pet>ik , na x>inw>il taj .
Kʼax ukemik le pas chawe .	Kʼax u>kem>ik le pas ch>aw>e .
Kʼax ukemik le pas chawe .	Kʼax u>kem>ik le pas ch>aw>e .
Ajitz ri Xep .	Ajitz ri Xep .
Ketuʼn ronojel qʼij ri alaj taq meʼs .	K>e>tuʼn r>onojel qʼij ri alaj taq meʼs .
Nutom le tzij …	Nu>tom le tzij …
Jaʼwilaʼ .	J>aʼw>il>aʼ .
Pa ri bʼe xkiraq jun alaj imul saq rij , xkikʼam bʼik .	Pa ri bʼe x>ki>raq jun alaj imul saq r>ij , x>ki>kʼam bʼi>k .
Kinwilo chi utz ri ajiʼ .	K>inw>il>o chi utz ri a>jiʼ .
Sibʼalaj kaq le apalaj .	Sibʼalaj kaq le a>palaj .
Kʼo ekikʼajol le achijabʼ .	Kʼo e>ki>kʼajol le achij>abʼ .
Xretaʼmaj .	X>r>etaʼma>j .
Xretaʼmaj .	X>r>etaʼma>j .
Kkamulix uchak ri abʼix .	K>kamulix u>chak ri abʼix .
Kebʼ nubʼiʼ kʼolik .	Kebʼ nu>bʼiʼ kʼol>ik .
Kimbʼe aqʼan rukʼ le al Talin .	K>im>bʼe aqʼan r>ukʼ le al Talin .
Xatalqilaʼ .	X>at>al>q>il>aʼ .
Ri chʼichʼ tzijom kanoq pa ri ukʼolbʼal .	Ri chʼichʼ tzijom kan>oq pa ri u>kʼolbʼal .
Ri ajtij kubʼij chike : rajawaxik keqachajij ri awaj , are utikoʼn ri Ajaw .	Ri ajtij k>u>bʼij chi>k>e : rajawaxik k>e>qa>chaji>j ri awaj , are u>tikoʼn ri Ajaw .
Kʼo chi wachiʼl chanim .	Kʼo chi w>achiʼl chanim .
Pa ri komon areʼ ekʼi winaqibʼ kichʼaw pa chʼabʼal kʼicheʼ , xuquje ekʼo le mosibʼ kichʼaw pa kaxlan tzij .	Pa ri komon areʼ ekʼi winaq>ibʼ k>i>chʼaw pa chʼabʼal kʼicheʼ , xuquje e>kʼo le mos>ibʼ k>i>chʼaw pa kaxlan tzij .
Latzʼ uwach ri bʼe .	Latzʼ u>wach ri bʼe .
Lal xintoʼwik .	Lal x>in>toʼ>w>ik .
Jas karaj kutijo ?	Jas ka>r>aj k>u>tij>o ?
Jachin xatqʼalunik ?	Jachin x>at>qʼalu>n>ik ?
Kʼo uxajabʼ ri akʼal .	Kʼo u>xajabʼ ri akʼal .
Chi relaqʼaxik kinaqʼ xeutaqchiʼj wi .	Chi r>elaqʼa>x>ik kinaqʼ x>e>u>taqchiʼ>j wi .
Xatqʼajik .	X>at>qʼaj>ik .
Xutij le wa .	X>u>tij le wa .
Ri a Teʼk xtzaq loq are chi kʼo pa uwiʼ ri qʼaʼm .	Ri a Teʼk x>tzaq loq are chi kʼo pa u>wiʼ ri qʼaʼm .
Ri uxaq le tzʼunuj utz che mes .	Ri u>xaq le tzʼunuj utz ch>e mes .
Xqilo chi na kukʼam ta rajil le asosyasyon .	X>q>il>o chi na k>u>kʼam ta rajil le asosyasyon .
Pa ri jaʼ kakʼojiʼ wi ri ixtutzʼ .	Pa ri jaʼ ka>kʼojiʼ wi ri ixtutzʼ .
Naqaj kintʼuyiʼ wi chawe .	Naqaj k>in>tʼuyiʼ wi ch>aw>e .
We na jupulik ta xeqajik ...	We na jupulik ta x>e>qaj>ik ...
We kʼo jun ktuqaʼrik , ¿ la man xoqujeʼ taj kintuqaʼr ri in ?	We kʼo jun k>tuqaʼr>ik , ¿ la man xoqujeʼ taj k>in>tuqaʼr ri in ?
We kawaj katintoʼo xaq xu wi kabʼij chi we .	We k>awaj k>at>in>toʼ>o xaq xu wi k>a>bʼij chi w>e .
Ri yoqʼoj xbʼan chi wech , kinutoʼ che usukʼmaxik wibʼ .	Ri yoqʼoj x>bʼan chi w>ech , k>in>u>toʼ ch>e u>sukʼma>x>ik w>ibʼ .
Ri xunkur kkʼojiʼ pa taq ri triko .	Ri xunkur k>kʼojiʼ pa taq ri triko .
Ri Luʼs waʼkatel .	Ri Luʼs waʼkatel .
Xojbʼinik .	X>oj>bʼin>ik .
Xojbʼinik .	X>oj>bʼin>ik .
Xojbʼinik .	X>oj>bʼin>ik .
Xnaʼtaj chke xatkisikʼij .	X>naʼtaj ch>k>e x>at>ki>sikʼi>j .
Chsikʼa ri muchuʼl .	Ch>sikʼ>a ri muchuʼl .
Che le sanik cheʼ kbʼan wi ri qʼojom .	Ch>e le sanik cheʼ k>bʼan wi ri qʼojom .
Ri qʼatzu , are qʼalaj ri uqʼijil .	Ri qʼatzu , are qʼalaj ri u>qʼijil .
Kʼo ij che le akʼal .	Kʼo ij ch>e le akʼal .
Ri axux are na ri ukunel ri kinaqʼ .	Ri axux are na ri u>kunel ri kinaqʼ .
Awas kbʼan kʼax che jun nim winaq .	Awas k>bʼan kʼax ch>e jun nim winaq .
Tajin kekʼul ri alaxik .	Tajin k>e>kʼul ri alaxik .
Ma ta kabʼe le nuxbʼal pa le tinamit .	Ma ta ka>bʼe le nu>xbʼal pa le tinamit .
Xrapap ri palomax .	X>rapap ri palomax .
Kaxlaʼn xan ri wachoch .	Kaxlaʼn xan ri w>achoch .
Chʼanal ri achi .	Chʼanal ri achi .
Ri Pal sibʼalaj xuʼy .	Ri Pal sibʼalaj xuʼy .
Xumaltyoxij che ri ajtij ronojel le xukʼut chi uwach .	X>u>maltyoxi>j ch>e ri aj>tij r>onojel le x>u>kʼut chi u>wach .
We Woktzʼibʼabʼal kʼo pa uqʼabʼ kuchajij xuqujeʼ kupatanij we taqanik riʼ , rachiʼl ri chomanem xuqujeʼ ri ucholchak .	We Woktzʼibʼabʼal kʼo pa u>qʼabʼ k>u>chajij xuqujeʼ k>u>patanij we taqanik riʼ , r>achiʼl ri choman>em xuqujeʼ ri u>cholchak .
Jeʼlik utiʼjolal ri saqkoʼr .	Jeʼl>ik u>tiʼjolal ri saqkoʼr .
Xixqachʼabʼej iwir .	X>ix>qa>chʼabʼe>j iwir .
Xinloqʼ kʼi wa .	X>in>loqʼ kʼi wa .
Xekiqʼil le ajchakibʼ xkiwok le ja .	X>e>ki>qʼil le ajchak>ibʼ x>ki>wok le ja .
Ri winaq kakibʼij chi kʼo jun bʼe , areʼ bʼe rech tinamit ubʼi Lemoʼ .	Ri winaq ka>ki>bʼij chi kʼo jun bʼe , areʼ bʼe r>ech tinamit u>bʼi Lemoʼ .
Ronojel qʼij ktoj ri nuchak .	R>onojel qʼij k>toj ri nu>chak .
We ta xakunaj le atat ma ta xkam laʼ .	We ta x>a>kuna>j le a>tat ma ta x>kam laʼ .
Jas xukʼam bʼi le tzʼiʼ xawilo ?	Jas x>u>kʼam bʼi le tzʼiʼ x>aw>il>o ?
Ri achalal junam kiwach .	Ri achalal junam ki>wach .
Chawilaʼ .	Ch>aw>il>aʼ .
Meʼs laʼ .	Meʼs laʼ .
Kinwaʼik rech na kinyowaj taj .	K>in>waʼ>ik r>ech na k>in>yowaj taj .
Kintzukuj la .	K>in>tzuku>j la .
Wech ri kem .	W>ech ri kem .
Qʼalaj chi na kawaj taj kabʼij .	Qʼalaj chi na k>awaj taj k>a>bʼij .
Are kʼu le melarsoprol kukunaj le kebʼ , waʼ xew kakoj chech T.b.r. rumal sibʼalaj kʼo uchuqʼabʼ we kunabʼal .	Are kʼu le melarsoprol k>u>kuna>j le kebʼ , waʼ xew ka>koj ch>ech T.b.r. r>umal sibʼalaj kʼo u>chuqʼabʼ we kunabʼal .
Are na nim ta le atzʼiʼ chuwach le nutzʼiʼ .	Are na nim ta le a>tzʼiʼ ch>u>wach le nu>tzʼiʼ .
Jeʼl ri qʼij kamik .	Jeʼl ri qʼij kamik .
Jun achi ubʼi Kuʼ xusipaj kebʼ kʼaʼm ulew rech kabʼan ri tijobʼal , kamik , kʼo chik ajtij rech ri komon Xechpup .	Jun achi u>bʼi Kuʼ x>u>sipaj kebʼ kʼaʼm ulew r>ech ka>bʼan ri tijobʼal , kamik , kʼo chik ajtij r>ech ri komon Xechpup .
Man utz taj kkaʼy ri akʼoj .	Man utz taj k>kaʼy ri a>kʼoj .
Xatkowinik xabʼano .	X>at>kowin>ik x>a>bʼan>o .
Utz we kinchakuj .	Utz we k>in>chaku>j .
Kamik le jaʼ kchojojik , kchojojik , katatajik pa ri juyubʼ .	Kamik le jaʼ k>chojoj>ik , k>chojoj>ik , ka>ta>taj>ik pa ri juyubʼ .
Tajin kqʼanarik ri wereʼaj .	Tajin k>qʼanar>ik ri wereʼaj .
Najil upam ri siwan .	Najil u>pam ri siwan .
Ri jabʼ kukʼan loq ri sutzʼ kumatz .	Ri jabʼ k>ukʼan loq ri sutzʼ kumatz .
Xinkosik rumal xinchakunik .	X>in>kos>ik r>umal x>in>chakun>ik .
Qonojel uj , uj Mayabʼ taq winaq .	Q>onojel uj , uj Mayabʼ taq winaq .
Tajin kewaʼkat ri alabʼom .	Tajin k>e>waʼkat ri alabʼom .
Ri nuchak are qʼaxel tzij .	Ri nu>chak are qʼaxel tzij .
Na xutij taj .	Na x>u>tij taj .
Are le ba xulik .	Are le ba x>ul>ik .
E nukej .	E nu>kej .
Kawaj katʼek .	Ka>w>aj k>at>ʼek .
Xojutaqchiʼj le achi chuloqʼik ichaj .	X>oj>u>taqchiʼ>j le achi ch>u>loqʼ>ik ichaj .
Xojutaqchiʼij xojwaʼik .	X>oj>u>taqchiʼi>j x>oj>waʼ>ik .
Le achi xkaʼy loq .	Le achi x>kaʼy loq .
We chatchakunik , kʼo awa .	We ch>at>chakun>ik , kʼo a>wa .
We chatchakunik , kʼo awa .	We ch>at>chakun>ik , kʼo a>wa .
Pixabʼ : man utz taj kʼax kujchʼaw chikij nikʼaj qachil .	Pixabʼ : man utz taj kʼax k>uj>chʼaw chi>k>ij nikʼaj q>achil .
Sibʼalaj qʼequʼm rumal ri mayul .	Sibʼalaj qʼequʼm r>umal ri mayul .
Rax , rax , rax , kʼokʼ , kʼokʼ , kʼokʼ le ruxlabʼ le taq tikoʼn .	Rax , rax , rax , kʼokʼ , kʼokʼ , kʼokʼ le r>uxlabʼ le taq tikoʼn .
E kʼo utobʼanelabʼ ri ajtʼisoʼm .	E kʼo u>tobʼanel>abʼ ri ajtʼisoʼm .
We achi xusipaj jun pʼot chwe .	We achi x>u>sipa>j jun pʼot ch>w>e .
Xinqʼax chi kixoʼl ri winaq .	X>in>qʼax chi ki>xoʼl ri winaq .
Ri pix tzʼaralik rumal ri eqaʼn .	Ri pix tzʼaralik r>umal ri eqaʼn .
Maj jachin xʼek .	Maj jachin x>ʼe>k .
Kinkowin chik kinajilan kʼa juwinaq .	K>in>kowin chik k>in>ajilan kʼa juwinaq .
Saq chi kan le ichaj rech katzako .	Saq chi kan le ichaj r>ech ka>tzak>o .
Ri watz kaqʼoxow ri ucheʼal rij .	Ri w>atz ka>qʼoxow ri u>cheʼal r>ij .
Kʼo jun nukʼotoj chiʼaj .	Kʼo jun nu>kʼotoj chiʼaj .
Xinloqʼ le nukʼakʼapoʼt .	X>in>loqʼ le nu>kʼakʼapoʼt .
Sibʼalaj al ri reqaʼn ri kej .	Sibʼalaj al ri r>eqaʼn ri kej .
Xinqʼiʼo xinatin pa joron .	X>in>qʼiʼ>o x>in>atin pa joron .
Sibʼalaj at kon .	Sibʼalaj at kon .
Ri komon Xechpup rech uqʼabʼ tinamit Xoʼl Abʼaj rech Qʼumarkaj .	Ri komon Xechpup r>ech u>qʼabʼ tinamit Xoʼl Abʼaj r>ech Qʼumarkaj .
Tzebʼal ukemik le pas awumal .	Tzebʼal u>kem>ik le pas aw>umal .
Le laj imul qʼeq rij , are kachʼopinik , ma kuxeʼj ta ribʼ , kʼate xrilo ma ekʼo ta chik ri rachalal .	Le laj imul qʼeq r>ij , are ka>chʼopin>ik , ma k>u>xeʼ>j ta r>ibʼ , kʼate x>r>il>o ma e>kʼo ta chik ri r>achalal .
Ri qatinamit laj chech unimal rulewal .	Ri qa>tinamit laj ch>ech u>nimal r>ulewal .
Xaq at molonel tzijtal .	Xaq at molonel tzijtal .
Xaq uj junam chi uwach ri Ajaw .	Xaq uj junam chi u>wach ri Ajaw .
Miqʼin ri lej .	Miqʼin ri lej .
Xbʼe che utzukuxik le ali .	X>bʼe ch>e u>tzuku>x>ik le ali .
Ri xibʼibʼal chi kʼo wi pa taq ri qakʼaslemal ronojel qʼij .	Ri xibʼibʼal chi kʼo wi pa taq ri qa>kʼaslemal r>onojel qʼij .
Ri winaq kubʼan we kʼaxkʼolil riʼ , kqʼat wajxaqibʼ wene wajxaqlajuj junabʼ chi rij pa cheʼ xuqujeʼ kutoj 300 mil kʼa pa 500 mil qʼuqʼ .	Ri winaq k>u>bʼan we kʼaxkʼolil riʼ , k>qʼat wajxaqibʼ wene wajxaqlajuj junabʼ chi r>ij pa cheʼ xuqujeʼ k>u>toj 300 mil kʼa pa 500 mil qʼuqʼ .
Xsachon kan uyaʼik le pwaq che cho ja .	X>sachon kan u>yaʼ>ik le pwaq ch>e ch>o ja .
Kʼax waʼim awumal .	Kʼax waʼ>im aw>umal .
Jobʼ raqan ri tzʼalam xeporoxik .	Jobʼ r>aqan ri tzʼalam x>e>poro>x>ik .
La xkunataj le ali awumal ?	La x>kuna>taj le ali aw>umal ?
Ri koj are ri jun awaj ajtiʼj .	Ri k>oj are ri jun awaj ajtiʼj .
¿ Jawchiʼ xataʼ che xkam ri umam ri Poʼx ?	¿ Jawchiʼ x>a>taʼ ch>e x>kam ri u>mam ri Poʼx ?
Xojtzalijik xixeʼqaqʼatuj kukʼ le itat inan .	X>oj>tzalij>ik x>ix>eʼ>qa>qʼatuj k>ukʼ le i>tat i>nan .
Are kawaj na kinʼe taj .	Are ka>w>aj na k>in>ʼe taj .
Kinwoyʼej katpetik .	K>inw>oyʼe>j k>at>pet>ik .
Xinalaxik chi upam ri cholbʼal qʼij kebʼ Aj .	X>in>alax>ik chi u>pam ri cholbʼal qʼij kebʼ Aj .
Noʼjim upachʼuxik le nuwiʼ .	Noʼjim u>pachʼu>x>ik le nu>wiʼ .
Kojonel ri Tin .	Kojonel ri Tin .
Jas ubʼixik … pa Kʼicheʼ ?	Jas u>bʼi>x>ik … pa Kʼicheʼ ?
Kaqʼax chech le 80% le kiriqom we yabʼilal keriqitaj pa República Democrática del Congo .	Ka>qʼax ch>ech le 80% le ki>riq>om we yabʼilal k>e>riq>itaj pa República Democrática del Congo .
Kʼo jupuq chij chi uxeʼ ri cheʼ .	Kʼo jupuq chij chi u>xeʼ ri cheʼ .
Kakowinik kabʼinik .	Ka>kowin>ik ka>bʼin>ik .
Jas xataqchiʼj le akʼal chutijik ?	Jas x>a>taqchiʼ>j le akʼal ch>u>tij>ik ?
Jas xataqchiʼj le akʼal chutijik ?	Jas x>a>taqchiʼ>j le akʼal ch>u>tij>ik ?
Ri kowilaj kej sibʼalaj ko na chi uwach ri kej .	Ri kowilaj kej sibʼalaj ko na chi u>wach ri kej .
Are le nuchak jun tzuqbʼal wibʼ .	Are le nu>chak jun tzuqbʼal w>ibʼ .
Are na aninaq ta kachʼaw chinuwach in .	Are na aninaq ta ka>chʼaw chi>nu>wach in .
Kremow ri qʼaqʼ .	K>remow ri qʼaqʼ .
Kʼo oj che ri akʼal .	Kʼo oj ch>e ri akʼal .
Ma ta ne xwaj le kʼuhjnem rukʼ le a Teʼk .	Ma ta ne x>w>aj le kʼuhjnem r>ukʼ le a Teʼk .
Ri saʼy rukʼ saqmoʼl utz che ri tzantzaqʼor .	Ri saʼy r>ukʼ saqmoʼl utz ch>e ri tzantzaqʼor .
Nojim katwaʼik .	Nojim k>at>waʼ>ik .
Xawaj xabʼano .	X>aw>aj x>a>bʼan>o .
Sibʼalaj anoʼjibʼal .	Sibʼalaj a>noʼjibʼal .
Kojulkitzukuj .	K>oj>ul>ki>tzuku>j .
Kinya jun rutzil iwach nutijoxelabʼ !	K>in>ya jun r>utzil i>wach nu>tijoxel>abʼ !
Kinya jun rutzil iwach nutijoxelabʼ !	K>in>ya jun r>utzil i>wach nu>tijoxel>abʼ !
Na nim ta raqan waʼ we cheʼ .	Na nim ta r>aqan waʼ we cheʼ .
Saq rij ri nukej .	Saq r>ij ri nu>kej .
Ri weqaʼn man al taj .	Ri w>eqaʼn man al taj .
Xaq xew xayojo .	Xaq xew x>a>yoj>o .
Jat xinchaʼ chi awe .	Jat x>in>chaʼ chi aw>e .
Che we junabʼ man kʼo taj tikoʼn xinbʼano .	Ch>e we junabʼ man kʼo taj tikoʼn x>in>bʼan>o .
Jawi xakʼam wuʼla laʼ le atzʼyaq ?	Jawi x>a>kʼam wuʼ>la laʼ le atzʼyaq ?
Jeʼ jas ri utat kkaʼyik .	Jeʼ jas ri u>tat k>kaʼy>ik .
Kinmeson na .	K>in>meson na .
¿ La katpe qukʼ chweʼq ?	¿ La k>at>pe q>ukʼ chweʼq ?
Xinsach che le uwokik le tzij .	X>in>sach ch>e le u>wok>ik le tzij .
Xinchʼaw apan rukʼ le wanabʼ .	X>in>chʼaw apan r>ukʼ le w>anabʼ .
Kchakun rukʼ ri josbʼal cheʼ ri ajanel .	K>chakun r>ukʼ ri josbʼal cheʼ ri ajanel .
Chqil ta bʼa qibʼ chweʼq .	Ch>q>il ta bʼa q>ibʼ chweʼq .
Ri upixabʼ le qʼatbʼal tzij kiyaʼ ubʼixik .	Ri u>pixabʼ le qʼatbʼal tzij k>iyaʼ u>bʼixik .
Saq uwiʼ ri tataʼ .	Saq u>wiʼ ri tataʼ .
Kʼo jun komon ubʼi Chikabʼraqan , kariqatajik pa tinamit Kʼicheʼ .	Kʼo jun komon u>bʼi Chikabʼraqan , ka>riq>ataj>ik pa tinamit Kʼicheʼ .
Pine ta ne maj nurajil , kimbʼe wi .	Pine ta ne maj nu>rajil , k>im>bʼe wi .
Nim nim uqʼij ri achi .	Nim nim u>qʼij ri achi .
Ri kok nojim xbʼek , xuchʼijo xopan pa ukʼisbʼalil le anim .	Ri k>ok nojim x>bʼe>k , x>u>chʼij>o x>opan pa u>kʼisbʼalil le anim .
Xujbʼe pa tzurik .	X>uj>bʼe pa tzurik .
Konojel ri alaxik keʼetzʼanik .	K>onojel ri alaxik k>eʼ>etzʼan>ik .
Ronojel upam ja ktzʼutuwik .	R>onojel u>pam ja k>tzʼutuw>ik .
Xinbʼe che loqʼoj .	X>in>bʼe ch>e loqʼoj .
Kamul xinpe che atzukuxik .	Kamul x>in>pe ch>e a>tzukuxik .
E petinaq pa bʼe le rachalaxik .	E petinaq pa bʼe le r>achalaxik .
Kuyaʼo xuqujeʼ are ri kʼaxkʼolil keʼopan pa kiwi ri jastaq rech .	K>u>yaʼ>o xuqujeʼ are ri kʼaxkʼolil k>eʼ>opan pa ki>wi ri jastaq r>ech .
Pa ri suʼt pisom wi ri lej .	Pa ri suʼt pisom wi ri lej .
Wetaʼam jachin kapetik .	W>etaʼam jachin ka>pet>ik .
Ri ja tzʼajom chik .	Ri ja tzʼajom chik .
Kʼax kʼolik , kachaʼ .	Kʼax kʼol>ik , ka>chaʼ .
Qech ri ja .	Q>ech ri ja .
Kawaj kinbʼij .	Ka>w>aj k>in>bʼij .
Ajchak ri achi .	Ajchak ri achi .
Ajqʼojom ri a Teʼk .	Ajqʼojom ri a Teʼk .
Le ali xel bʼik .	Le ali x>el bʼi>k .
Man rukʼ ta ikaj xuchʼaybʼej .	Man r>ukʼ ta ikaj x>u>chʼaybʼe>j .
Xinmuʼl rumal ri jabʼ .	X>in>muʼl r>umal ri jabʼ .
Ri nuwakax xutij jun qʼoqʼ rumal riʼ xkamik .	Ri nu>wakax x>u>tij jun qʼoqʼ r>umal riʼ x>kamik .
Kʼo chʼumil chi uwach ri kaj .	Kʼo chʼumil chi u>wach ri kaj .
Jawi xsachon wi kan uyaʼik le pwaq che .	Jawi x>sachon wi kan u>yaʼ>ik le pwaq ch>e .
Qilik .	Q>il>ik .
Jun nimalaj tzʼiʼ .	Jun nim>alaj tzʼiʼ .
Areʼ retaʼm che kinopanik .	Areʼ r>etaʼm ch>e k>in>opan>ik .
Jukʼulaj winaq xeʼanimaj bʼik .	Jukʼulaj winaq x>eʼ>animaj bʼi>k .
Pa ri qatzantzaqʼor kkʼiy loq ri qanoʼjibʼal .	Pa ri qa>tzantzaqʼor k>kʼiy loq ri qa>noʼjibʼal .
Kekʼiy ri amolo chi upam ri mes .	K>e>kʼiy ri amolo chi u>pam ri mes .
Ri yawal kukoj ri ali chi uxeʼ ri chakach are usuʼt .	Ri yawal k>u>koj ri ali chi u>xeʼ ri chakach are u>suʼt .
La utz we kinbʼij … ?	La utz we k>in>bʼi>j … ?
Kʼate xrilo , xpe ri unan che utzukuxik , xkikotik , xusalabʼisaj ri taq uxkin .	Kʼate x>r>ilo , x>pe ri u>nan ch>e u>tzuku>x>ik , x>kikot>ik , x>u>salabʼisa>j ri taq u>xkin .
Ri tuʼ are jun qʼayes kkʼiy pa taq abʼix .	Ri tuʼ are jun qʼayes k>kʼiy pa taq abʼix .
Utz le nuqʼabʼ .	Utz le nu>qʼabʼ .
Kinbʼinik xinʼek .	K>in>bʼin>ik x>in>ʼe>k .
Xenutaqchʼij kekil le akʼalabʼ .	X>e>nu>taqchʼi>j k>e>k>il le akʼal>abʼ .
Kʼakʼ le poʼt .	Kʼakʼ le poʼt .
Xqata chi xatulik .	X>qa>ta chi x>at>ul>ik .
Xubʼij che : - sachaʼ la numak nan , man kinbʼan ta chik , kinimaj tzij la .	X>u>bʼij ch>e : - sach>aʼ la nu>mak nan , man k>in>bʼan ta chik , ki>nimaj tzij la .
Xineʼbʼinoq .	X>in>eʼ>bʼin>oq .
Ajilanel uchak areʼ .	Ajilanel u>chak areʼ .
Kikunaxik akʼalabʼ xretaʼmaj .	Ki>kuna>x>ik akʼal>abʼ x>r>etaʼma>j .
Ri ukʼaʼ utz che qasiʼ .	Ri ukʼaʼ utz ch>e qa>siʼ .
Xinqʼil ri a Poʼx che man kachakun taj .	X>in>qʼil ri a Poʼx ch>e man ka>chakun taj .
Le winaq pa le chʼichʼ e tʼuyul lo wi .	Le winaq pa le chʼichʼ e tʼuyul lo wi .
« Makʼam ubʼi weriʼ , matij weriʼ , machap weriʼ » .	« M>a>kʼam u>bʼi weriʼ , m>a>tij weriʼ , m>a>chap weriʼ » .
Xu wi ubʼaqilal ri winaq man kaqʼayir taj .	Xu wi u>bʼaqilal ri winaq man ka>qʼayir taj .
Nabʼe xatopanik .	Nabʼe x>at>opan>ik .
Xkitijo jas xuloqʼo le ixoqibʼ .	X>ki>tij>o jas x>u>loqʼ>o le ixoq>ibʼ .
Xuloqʼ ri wuj rumal ri ali .	X>ul>oqʼ ri wuj r>umal ri ali .
Aninaqil katpetik .	Aninaqil k>at>pet>ik .
Kʼa te xkilo ekʼo jujun chomaʼq taq cheʼ sibʼalaj , jeʼl kimujal , xuqujeʼ kʼo jun nimalaj bʼinel jaʼ , jun nim uwosaq .	Kʼa te x>k>il>o e>kʼo jujun chom>aʼq taq cheʼ sibʼ>alaj , jeʼl ki>mujal , xuqujeʼ kʼo jun nim>alaj bʼinel jaʼ , jun nim uwosaq .
E julajuj ri akʼ .	E julajuj ri akʼ .
Chpe ta bʼa le loqʼalaj jabʼ .	Ch>pe ta bʼa le loqʼ>alaj jabʼ .
Rumal ri yabʼil xbʼaqarik .	R>umal ri yabʼil x>bʼaqar>ik .
La kʼo jun kʼotoj chiʼaj ?	La kʼo jun kʼotoj chiʼaj ?
Xanimaj ri akʼal chi uwach ri uchuch .	X>animaj ri akʼal chi u>wach ri u>chuch .
E kʼo jobʼ chʼil wakʼ .	E kʼo jobʼ chʼil w>akʼ .
Tajin kewaʼ ri imul .	Tajin k>e>waʼ ri imul .
Na xkikamsaj taj xkikʼam bʼi choja .	Na x>ki>kamsaj taj x>ki>kʼam bʼi cho>ja .
Ri uchʼuʼjilal ri ali Toʼn .	Ri u>chʼuʼjilal ri ali Toʼn .
La xutij kʼu le wa ?	La x>u>tij kʼu le wa ?
Ri ajtij , kyajon chi kech ri akʼalabʼ .	Ri ajtij , k>yajon chi k>ech ri akʼal>abʼ .
Na rax ta uwach le juyubʼ .	Na rax ta u>wach le juyubʼ .
E kʼo kʼi taq chikop chi uwach ri taqʼaj .	E kʼo kʼi taq chikop chi u>wach ri taqʼaj .
Tajin katchʼopin chi uwach ri taqʼaj .	Tajin k>at>chʼopin chi u>wach ri taqʼaj .
La xpe le achi le xinkunan iwir ?	La x>pe le achi le x>in>kuna>n iwir ?
Xpax ri bʼoʼj .	X>pax ri bʼoʼj .
Nutum kanoq ri siʼ .	Nu>tum kan>oq ri siʼ .
Kʼo jun qariqoj qibʼ chweʼq .	Kʼo jun qa>riqoj q>ibʼ chweʼq .
Rumal laʼ xkoj “ Xalqʼat ” che ubʼiʼ ri komon .	R>umal laʼ x>koj “ Xalqʼat ” ch>e u>bʼiʼ ri komon .
Paqal rajil ri ikaj .	Paqal rajil ri ikaj .
Le e qʼeqa taq meʼs .	Le e qʼeq>a taq meʼs .
Chanim kwaj katpetik .	Chanim k>w>aj k>at>pet>ik .
Xeqil le chikop puwi le ja .	X>e>q>il le chikop p>u>wi le ja .
Xinxuliʼ qajoq .	X>in>xuliʼ qaj>oq .
Kʼo na ruxlabʼ ri awaj .	Kʼo na r>uxlabʼ ri awaj .
Xatriyeʼj le a Tun pa le bʼe .	X>at>r>iyeʼ>j le a Tun pa le bʼe .
Xojkisikʼij .	X>oj>ki>sikʼi>j .
Pa jun qʼij riʼ , le a Teʼk , kel ukʼuʼx chech ri joʼq , man karaj ta chik kakʼatisax le joʼq .	Pa jun qʼij riʼ , le a Teʼk , k>el u>kʼuʼx ch>ech ri joʼq , man ka>r>aj ta chik ka>kʼatisa>x le joʼq .
Sibʼalaj latzʼ uchak ri alkalte .	Sibʼalaj latzʼ u>chak ri alkalte .
Jelaʼ pa ri timinit Chwikabyok rech Xelajuʼ , le qanan qatat kakitiko jeʼlalaj taq uwach ichaj .	Jelaʼ pa ri timinit Chwikabyok r>ech Xelajuʼ , le qa>nan qa>tat ka>ki>tiko jeʼl>alaj taq u>wach ichaj .
Xloʼtaj ri akʼal .	X>loʼtaj ri akʼal .
Uj kʼo pa uwuq qʼij .	Uj kʼo pa uwuq qʼij .
Ri kej xtuqaʼrik chi uxeʼ le reqaʼn .	Ri kej x>tuqaʼr>ik chi u>xeʼ le r>eqaʼn .
Chitatabʼej jas ri kimbʼij chiwe .	Ch>i>tatabʼe>j jas ri k>im>bʼi>j ch>iw>e .
Xinsikʼij alaq .	X>in>sikʼi>j alaq .
Jeriʼ kkibʼan chkech ri winaq .	Jeriʼ k>ki>bʼan ch>k>ech ri winaq .
Tin Chuta , ubʼiʼ ri tataʼ .	Tin Chuta , u>bʼiʼ ri tataʼ .
Kintij na le akʼ .	K>in>tij na le akʼ .
Xbʼe qʼij !	X>bʼe qʼij !
Kubʼan ri uxoqʼoʼl ri ajtzʼaq .	K>u>bʼan ri u>xoqʼoʼl ri ajtzʼaq .
Kimbʼe pa le tinamit .	K>im>bʼe pa le tinamit .
Kimbʼe pa le tinamit .	K>im>bʼe pa le tinamit .
Xesikʼij la .	X>e>sikʼi>j la .
Xnaʼtaj chke chi xeatinik .	X>naʼtaj ch>k>e chi x>e>atin>ik .
Xnaʼtaj chke chi xeatinik .	X>naʼtaj ch>k>e chi x>e>atin>ik .
Kakitik ixim ri achijabʼ .	Ka>ki>tik ixim ri achij>abʼ .
Xchoy ri qʼayes rukʼ ri choyibʼal .	X>choy ri qʼayes r>ukʼ ri choyibʼal .
Le nutat kaloqʼon chwe .	Le nu>tat ka>loqʼo>n ch>w>e .
Ri uwiʼ suq utz che ri qakikʼel .	Ri u>wiʼ suq utz ch>e ri qa>kikʼel .
La xatok kʼu chi ratinsaxik awibʼ ?	La x>at>ok kʼu chi r>atinsa>x>ik aw>ibʼ ?
In xinchʼayow le achi .	In x>in>chʼay>ow le achi .
In kʼo pa le ukʼisbʼal cholaj .	In kʼo pa le u>kʼisbʼal cholaj .
Ri nan Toʼn xubʼij chech : - xa rumal awas , le joʼq areʼ ratzʼyaq ri jal , ratzʼyaq ri qawa .	Ri nan Toʼn x>u>bʼij ch>ech : - xa r>umal awas , le joʼq areʼ r>atzʼyaq ri jal , r>atzʼyaq ri qa>wa .
Kʼo jun chikop ubʼiʼ pum .	Kʼo jun chikop u>bʼiʼ pum .
Xojilik .	X>oj>il>ik .
Xujchʼay bʼik .	X>uj>chʼay bʼi>k .
Kumajibʼej , pa le nabʼe ukʼutunik le yabʼilal , kayaʼtaj qʼaqʼal , uqʼoxom jolomaj , kʼaqat , chiʼl uqʼoxom le bʼaqilal .	Kumajibʼej , pa le nabʼe u>kʼutunik le yabʼilal , ka>yaʼ>taj qʼaqʼal , u>qʼoxom jolom>aj , kʼaqat , chiʼl u>qʼoxom le bʼaqilal .
Kaqariq qibʼ chweʼq .	Ka>qa>riq q>ibʼ chweʼq .
Jawi xojʼe wi chuloqʼik ?	Jawi x>oj>ʼe wi ch>u>loqʼ>ik ?
Nim ri kʼisis .	Nim ri kʼisis .
Ronojel winaq kril na ri ukolonem ri Dyos » .	R>onojel winaq k>r>il na ri u>kolon>em ri Dyos » .
Are ri ixoq xinsikʼin uloq .	Are ri ixoq x>in>sikʼin uloq .
Ri tat nan ojer na xkaj taj cher ri ali xkojiʼ ta ne pa ri tijobʼal .	Ri tat nan ojer na x>k>aj taj ch>er ri ali x>kojiʼ ta ne pa ri tijobʼal .
Xkunax le yawabʼ rumal le aj qʼij .	X>kuna>x le yawabʼ r>umal le aj qʼij .
Xinta jachin xulik .	X>in>ta jachin x>ul>ik .
Kʼo puj chi upam ri chʼaʼk .	Kʼo puj chi u>pam ri chʼaʼk .
Kukʼayij uwach ajacheʼ ri akʼal .	K>u>kʼayi>j u>wach ajacheʼ ri akʼal .
Ri xaʼr kʼo pa uwiʼ ri qʼaqʼ kpoqʼowik .	Ri xaʼr kʼo pa u>wiʼ ri qʼaqʼ k>poqʼow>ik .
Rax ronojel ri qʼayes rumal le jabʼ .	Rax r>onojel ri qʼayes r>umal le jabʼ .
Sibʼalaj nichʼ le nuchʼichʼ .	Sibʼalaj nichʼ le nu>chʼichʼ .
Kjoror ri qʼij .	K>joror ri qʼij .
Xinnaʼo chi xattʼuyeʼik .	X>in>naʼ>o chi x>at>tʼuyeʼ>ik .
Are ri utat ri Max kpetik .	Are ri u>tat ri Max k>pet>ik .
Bʼay xaq si xintatabʼej na in taq xumaj ubʼixik laʼ le jwes ...	Bʼay xaq si x>in>tatabʼej na in taq x>u>maj u>bʼi>x>ik laʼ le jwes ...
Bʼay xaq si xintatabʼej na in taq xumaj ubʼixik laʼ le jwes ...	Bʼay xaq si x>in>tatabʼej na in taq x>u>maj u>bʼi>x>ik laʼ le jwes ...
Le rajil , la pa ja xelaqʼax wuʼbʼik ?	Le rajil , la pa ja x>elaqʼa>x wuʼ>bʼi>k ?
E kʼo oxibʼ akʼ .	E kʼo oxibʼ akʼ .
Ri numiʼal xutaq loq jun taqoʼm wuj chi we .	Ri nu>miʼal x>u>taq loq jun taqoʼm wuj chi w>e .
Man kewaʼ taj ri alajibʼ .	Man k>e>waʼ taj ri alaj>ibʼ .
Nin chik ri rikil .	Nin chik ri rikil .
We katatin rukʼ kʼatan jaʼ man kuqʼatej ta le kʼakʼ yabʼil coronavirus .	We k>at>atin r>ukʼ kʼatan jaʼ man k>u>qʼatej ta le kʼakʼ yabʼil coronavirus .
Luʼ Tzʼalam ubʼiʼ ri achi kel Pa nim Cheʼ .	Luʼ Tzʼalam u>bʼiʼ ri achi k>el Pa nim Cheʼ .
We kechajix taq le kʼwa jacha kinbʼij ; junalik kʼo jaʼ xuqujeʼ sibʼalaj saqloloj .	We k>e>chaji>x taq le kʼwa jacha k>in>bʼij ; junalik kʼo jaʼ xuqujeʼ sibʼalaj saqloloj .
Na kawar ta la .	Na ka>war ta la .
Na xqil ta chik chi kukʼam rajil le asosyasyon .	Na x>q>il ta chik chi k>u>kʼam rajil le asosyasyon .
Ri alabʼom ri alitomabʼ tajin kikitijoj kibʼ rech sutaq , are kakaj kikibʼan nimaq achijabʼ chupam ri kikʼaslemal , xuquje kʼo chik jupuq bʼixonel chupam ri komon .	Ri alabʼom ri alitom>abʼ tajin ki>ki>tijo>j k>ibʼ r>ech sutaq , are ka>kaj ki>ki>bʼan nim>aq achij>abʼ ch>u>pam ri ki>kʼaslemal , xuquje kʼo chik jupuq bʼixonel ch>u>pam ri komon .
Kinchakunik rech kinwaʼik .	K>in>chakun>ik r>ech k>in>waʼ>ik .
Kinchakunik rech kinwaʼik .	K>in>chakun>ik r>ech k>in>waʼ>ik .
Rukʼ taq we tzij riʼ , xkikʼam ri kiqasnaʼ pa ri ubʼi ri Ajawxel Jesus ;	R>ukʼ taq we tzij riʼ , x>ki>kʼam ri ki>qasnaʼ pa ri u>bʼi ri Ajawxel Jesus ;
Ri tijonel naj kpe wi .	Ri tijonel naj k>pe wi .
Oj oj wokol ja .	Oj oj wokol ja .
Luʼs ubʼiʼ ri recham .	Luʼs u>bʼiʼ ri r>echam .
Ri tat Xwan potzʼ .	Ri tat Xwan potzʼ .
Xinchapo su xuloqʼo .	X>in>chap>o su x>u>loqʼ>o .
Xinwil wibʼ .	X>inw>il w>ibʼ .
We ta ma ta aqʼabʼ kabʼek , maj ta utem laʼ kuriq pa le nimachʼichʼ .	We ta ma ta aqʼabʼ ka>bʼe>k , maj ta u>tem laʼ k>u>riq pa le nimachʼichʼ .
Xekanaj kan le ajchakibʼ .	X>e>kanaj kan le ajchak>ibʼ .
Xekanaj kan le ajchakibʼ .	X>e>kanaj kan le ajchak>ibʼ .
Tajin kpe usiʼjal ri karwaʼn .	Tajin k>pe u>siʼjal ri karwaʼn .
Kutij ixim ri akʼ .	K>u>tij ixim ri akʼ .
Kamul kinwaʼ na .	Kamul k>in>waʼ na .
Xopan jun qʼij xbʼe utukel pa tijobʼal xuriq apanoq jupuq tzʼiʼ pa ri bʼe .	X>opan jun qʼij x>bʼe u>tukel pa tijobʼal x>u>riq apan>oq jupuq tzʼiʼ pa ri bʼe .
Chom ri a Max .	Chom ri a Max .
Nim ri ukʼuʼx ri amaqʼ .	Nim ri u>kʼuʼx ri amaqʼ .
Ri tapaʼl kubʼan kʼax we man chʼajom taj .	Ri tapaʼl k>u>bʼan kʼax we man chʼajom taj .
Kʼax le uwiʼ taq le nuqʼabʼ .	Kʼax le u>wiʼ taq le nu>qʼabʼ .
Xojukʼam uloq rech kojrilo .	X>oj>u>kʼam uloq r>ech k>oj>r>il>o .
Kʼo chwa roʼch le pare .	Kʼo ch>wa r>oʼch le pare .
Je waʼ katpetik .	Je waʼ k>at>pet>ik .
Na xutij ta le wa .	Na x>u>tij ta le wa .
Chinkʼasiʼ ta bʼa na chixoʼl .	Ch>in>kʼasiʼ ta bʼa na ch>i>xoʼl .
Itzel kawil le jabʼ , we katkamik pa jabʼ katmuq wi .	Itzel k>aw>il le jabʼ , we k>at>kam>ik pa jabʼ k>at>muq wi .
Kʼaʼn ri kʼayinel chʼichʼ .	Kʼaʼn ri kʼayinel chʼichʼ .
At kʼo pa siwan !	At kʼo pa siwan !
Ketekik ri ikʼ .	Ketekik ri ikʼ .
Ri nukʼul ja ajitz .	Ri nu>kʼul ja ajitz .
Xatulik xatalkiʼkota kukʼ le awalkʼwal .	X>at>ul>ik x>at>al>kiʼkot>a k>ukʼ le awalkʼwal .
Maʼtam xatpe che ri waʼim .	Maʼtam x>at>pe ch>e ri waʼim .
Ri Trix kchakun ronojel qʼij pa tinamit .	Ri Trix k>chakun r>onojel qʼij pa tinamit .
Kʼo chik jun ja rech kekunax ri yabʼ taq winaq .	Kʼo chik jun ja r>ech k>e>kunax ri yabʼ taq winaq .
Areʼ uxeʼ ojer tzij waral Kʼicheʼ ubʼiʼ .	Areʼ u>xeʼ ojer tzij waral Kʼicheʼ u>bʼiʼ .
Kinqʼax rukʼ ri nunan .	K>in>qʼax r>ukʼ ri nu>nan .
Tajin kinatinik .	Tajin k>in>atin>ik .
Xyil ix hawayi .	X>y>il ix ha>way>i .
Kakitij le kinaqʼ , le ichaj , le uwaʼl ik rukʼ lej .	Ka>ki>tij le kinaqʼ , le ichaj , le u>waʼl ik r>ukʼ lej .
Are kʼu le palomax xubʼij che : - mam katbʼison taj , kinsikʼij nikʼaj wachiʼl kerapapik .	Are kʼu le palomax x>u>bʼij ch>e : - mam k>at>bʼison taj , k>in>sikʼi>j nikʼaj w>achiʼl k>e>rapap>ik .
Pa taq we qʼij kʼo ri jamaril .	Pa taq we qʼij kʼo ri jamaril .
Xqachap kikunaxik .	X>qa>chap ki>kunax>ik .
Elemen konojel ri akʼalabʼ .	Elemen k>onojel ri akʼal>abʼ .
Ri akʼal jupulik .	Ri akʼal jupulik .
Aninaq ukemik le pas awumal .	Aninaq u>kem>ik le pas aw>umal .
Areʼ xraj xinbʼano .	Areʼ x>r>aj x>in>bʼan>o .
Xkʼis ri nusiʼ .	X>kʼis ri nu>siʼ .
Are taq xujbʼe pa uwiʼ ri cho xeqasutij ri tinamit .	Are taq x>uj>bʼe pa u>wiʼ ri cho x>e>qa>suti>j ri tinamit .
Chu chu ri par .	Chu chu ri par .
Xinpe loq te kʼuriʼ xintzukuj ronojel ri nurajil .	X>in>pe loq te kʼuriʼ x>in>tzuku>j r>onojel ri nu>rajil .
Chi upam ri ubʼuch ri akʼ kʼo abʼaj , ixim chiʼl ri ichaj .	Chi u>pam ri u>bʼuch ri akʼ kʼo abʼaj , ixim chiʼl ri ichaj .
Kjaʼjat chi wij .	K>jaʼjat chi w>ij .
Jas rukʼ xkichap wi utijik le rikil ?	Jas r>ukʼ x>ki>chap wi u>tij>ik le rikil ?
Ri oj kʼo ajchaqʼe .	Ri oj kʼo ajchaqʼe .
Ri chʼaʼn sachinaq pa taq abʼix .	Ri chʼaʼn sachinaq pa taq abʼix .
Utz kamuq ri mes .	Utz ka>muq ri mes .
Le nimatijobʼal ri kakʼut wi ri qachʼabʼal , sibʼalaj naj kʼo wi .	Le nimatijobʼal ri ka>kʼut wi ri qa>chʼabʼal , sibʼalaj naj kʼo wi .
Na xinwil ta le meʼs pa ja .	Na x>inw>il ta le meʼs pa ja .
Ri ajtzʼibʼ rech chakunem rech Woktzʼibʼabʼal , kjach reqeleʼn rumal ri Ukʼabʼ kʼamal Ubʼe Amaqʼ .	Ri ajtzʼibʼ r>ech chakunem r>ech Woktzʼibʼabʼal , k>jach r>eqeleʼn r>umal ri U>kʼabʼ kʼamal U>bʼe Amaqʼ .
Kinusikʼij le nunan .	K>in>u>sikʼi>j le nu>nan .
Kʼo nuwuj .	Kʼo nu>wuj .
E kʼo jobʼ umiʼal , ri nutat .	E kʼo jobʼ u>miʼal , ri nu>tat .
Xinchapo .	X>in>chap>o .
Pa ri kiqʼij kaminaqibʼ kbʼan qʼor ikʼyaʼ rech aj : nabʼe ri nan kutzukuj kan ri aj , kujachʼoʼ xuquje kukʼeto .	Pa ri ki>qʼij kaminaq>ibʼ k>bʼan qʼor ikʼyaʼ r>ech aj : nabʼe ri nan k>u>tzuku>j kan ri aj , k>u>jachʼoʼ xuquje k>u>kʼeto .
Kʼo lemoʼ chi wochoch .	Kʼo lemoʼ chi w>ochoch .
Kaqitzʼnaj ri uxajabʼ ri akʼal .	Ka>qitzʼnaj ri u>xajabʼ ri akʼal .
Na kujwar ta waral .	Na k>uj>war ta waral .
Kpe na ri qʼatoj tzij .	K>pe na ri qʼatoj tzij .
¿ Jas che kʼo itzel taq achomabʼal ?	¿ Jas ch>e kʼo itzel taq a>chomabʼal ?
Jas xurayij le anan xutijo ?	Jas x>u>rayi>j le a>nan x>u>tij>o ?
Kakitij alanxax ri winaq .	Ka>ki>tij alanxax ri winaq .
Kʼo pa ri jul ri kumatz .	Kʼo pa ri jul ri kumatz .
Xinloqʼ jun chʼichʼ pa taqilal .	X>in>loqʼ jun chʼichʼ pa taqilal .
Xukachʼ rukʼ le uware .	X>u>kachʼ r>ukʼ le u>ware .
Poqon ri ik .	Poqon ri ik .
Kachuqʼchut ri jaʼ chi apam .	Ka>chuqʼchut ri jaʼ chi a>pam .
Keʼtzʼan le akʼalabʼ chech owan ibʼ .	K>eʼ>tzʼan le akʼal>abʼ ch>ech owan ibʼ .
Ri a Kel kʼo che ajpatan .	Ri a K>el kʼo ch>e ajpatan .
Kʼo sibʼalaj uchuqʼabʼ ri Xwan .	Kʼo sibʼalaj u>chuqʼabʼ ri Xwan .
We katnimanik utz kelik .	We k>at>niman>ik utz k>el>ik .
Jeʼ xqabʼano .	Jeʼ x>qa>bʼan>o .
Ri watiʼt kubʼan na ri upatan .	Ri w>atiʼt k>u>bʼan na ri u>patan .
Jachin ri achi ?	Jachin ri achi ?
Katpe .	K>at>pe .
Na xnaʼtaj ta chke xeatinik .	Na x>naʼtaj ta ch>k>e x>e>atin>ik .
Qaqil chi na qibʼ !	Q>aqil chi na q>ibʼ !
Ri bʼe laj uwach .	Ri bʼe laj u>wach .
Xsachon chke jachin xeatinik .	X>sachon ch>k>e jachin x>e>atin>ik .
Areʼ kachakun ronojel qʼij .	Areʼ ka>chakun r>onojel qʼij .
Xinkosik , rumal riʼ na kimbʼe pa le tijobʼal .	X>in>kos>ik , r>umal riʼ na k>im>bʼe pa le tijobʼal .
We chabʼij , na katinchʼabʼej ta chik .	We ch>a>bʼi>j , na k>at>in>chʼabʼe>j ta chik .
Che we qʼij kamik kʼo jun nutzijonem chirij le nutinamit .	Ch>e we qʼij kamik kʼo jun nu>tzijonem chi>r>ij le nu>tinamit .
Kakoj kyaq usok ri unan rech kachʼaj bʼik .	K>a>koj kyaq u>sok ri u>nan r>ech k>a>chʼaj bʼi>k .
Xkʼulmataj pa jun Komon chiʼ uwach jun juyubʼ , xuriqa jun qʼij xkiriq kibʼ jun imul rukʼ le kok .	X>kʼulmataj pa jun Komon chiʼ u>wach jun juyubʼ , x>u>riqa jun qʼij x>ki>riq k>ibʼ jun imul r>ukʼ le kok .
Xex ruxlabʼ ri rikil .	Xex r>uxlabʼ ri rikil .
Ri a Triʼx petinaq pa bʼe .	Ri a Triʼx petinaq pa bʼe .
Le achi xkaʼy chuʼloq .	Le achi x>kaʼy chuʼ>loq .
Xril ri a Xwan chi xwaʼ ri ala .	X>r>il ri a Xwan chi x>waʼ ri ala .
Nim we abʼaj .	Nim we abʼaj .
La kaj la kujtzalij la aninaq ?	La k>>aj la k>uj>tzalij la aninaq ?
La xutij kʼut ?	La x>u>tij kʼut ?
Xojutaqchiʼij xojʼek .	X>oj>u>taqchiʼi>j x>oj>ʼe>k .
Chi raqan kabʼin wi ri tataʼ .	Chi r>aqan ka>bʼin wi ri tataʼ .
Xqatijo .	X>qa>tij>o .
Retaʼm uwach jachin xloqʼow ri pas .	R>etaʼm u>wach jachin x>loqʼow ri pas .
Rajawaxik kqakoj utzij ri Ajqʼij .	Rajawaxik k>qa>koj u>tzij ri Ajqʼij .
Awech le ja .	Aw>ech le ja .
Kʼo jun Tabʼal pa uwiʼ ri xkanul ubʼiʼ Lajuj Noʼj .	Kʼo jun Tabʼal pa u>wiʼ ri xkanul u>bʼiʼ Lajuj Noʼj .
Ri alaj Tintin xbʼisonik , te xrilo kropopik xpeʼ jun palomax .	Ri alaj Tintin x>bʼison>ik , te x>r>il>o k>ropop>ik x>peʼ jun palomax .
Jachin che kinya wi le wuj ?	Jachin ch>e k>in>ya wi le wuj ?
Le imul xubʼij : kok , katkowin taj katzaq anim , nojim katbʼinik .	Le imul x>u>bʼij : kok , k>at>kowin taj ka>tzaq anim , nojim k>at>bʼin>ik .
Tajin kqʼax ri muqunijik .	Tajin k>qʼax ri muqunijik .
Xanimaj bʼik ri kuk .	X>animaj bʼi>k ri kuk .
Xekiqʼil le ajchakibʼ kakiwok le ja .	X>e>ki>qʼil le ajchak>ibʼ ka>ki>wok le ja .
Ubʼantajik le nutinamit .	U>bʼantajik le nu>tinamit .
Na xeʼe taj na xeʼkiqʼatuj taj .	Na x>e>ʼe taj na x>eʼ>ki>qʼatu>j taj .
Kkunan ri achi .	K>kunan ri achi .
¿ Jampaʼ kujbʼe pa nimaqʼij ?	¿ Jampaʼ k>uj>bʼe pa nimaqʼij ?
Pa juyubʼ Sibʼalaj raqan neʼ kʼolik .	Pa juyubʼ Sibʼalaj r>aqan neʼ kʼol>ik .
Oj ajtijabʼ .	Oj ajtij>abʼ .
Saq uwiʼ ri numam .	Saq u>wiʼ ri nu>mam .
Xalax jun neʼ .	X>alax jun neʼ .
Na xintaqchiʼj ta le wachajil kachakunik .	Na x>in>taqchiʼ>j ta le w>achajil ka>chakun>ik .
Xwaʼik .	X>waʼ>ik .
Xukʼut le Kʼicheʼ chʼabʼal le al Nela chqawach .	X>u>kʼut le Kʼicheʼ chʼabʼal le al Nela ch>qa>wach .
La kʼo na kikʼoxomaj taj ?	La kʼo na k>i>kʼoxoma>j taj ?
Ajchak we ala .	Ajchak we ala .
Rajawaxik kakʼaman chawe le utijik le lej .	Rajawaxik ka>kʼaman ch>aw>e le u>tijik le lej .
Yaʼtal chaqe qonojel ri uj winaq utz kaqil qibʼ .	Yaʼtal ch>aq>e q>onojel ri uj winaq utz k>aqil q>ibʼ .
Xuta jampaʼ kojʼek .	X>u>ta jampaʼ k>oj>ʼe>k .
Kinkowinik kimbʼek .	K>in>kowin>ik k>im>bʼe>k .
Xinkʼastaj pa kabʼlajuj kajbʼal .	X>in>kʼastaj pa kabʼlajuj kajbʼal .
Kojbʼinik .	K>oj>bʼin>ik .
Koqʼ ri akʼal .	K>oqʼ ri akʼal .
Xkʼam ri wa .	X>kʼam ri wa .
Kʼakʼ ri abʼ .	Kʼakʼ ri abʼ .
Le roʼch le a Teʼk kʼo chwach le ukʼay le nunan .	Le r>oʼch le a Teʼk kʼo ch>wach le u>kʼay le nu>nan .
Chi awij kʼo jun siwan .	Chi aw>ij kʼo jun siwan .
Konojel ri akʼalabʼ sibʼalaj utz xkil le imul .	K>onojel ri akʼal>abʼ sibʼalaj utz x>k>il le imul .
Jeʼl ktijow utiʼjolal ri ayin .	Jeʼl k>tijow u>tiʼjolal ri ayin .
Katʼek xinta .	K>at>ʼek x>in>ta .
Jawi xkibʼij wi chi keʼe wi ?	Jawi x>ki>bʼij wi chi k>e>ʼe wi ?
Jawi xkibʼij wi chi keʼe wi ?	Jawi x>ki>bʼij wi chi k>e>ʼe wi ?
Wachʼom ri kiwa ri noʼs .	Wachʼom ri ki>wa ri noʼs .
We ala sibʼalaj xkikotik xuriqaʼ ri uchim chajital rumal ri laj a Paʼtz .	We ala sibʼalaj x>kikot>ik x>u>riqaʼ ri u>chim chajital r>umal ri laj a Paʼtz .
Jas xojukʼam lo chukʼayixik ?	Jas x>oj>u>kʼam lo ch>u>kʼayi>x>ik ?
Pa Tujal kkʼiy ri jeʼlik qʼinom .	Pa Tujal k>kʼiy ri jeʼl>ik qʼinom .
Mesom kanoq ri upam ja .	Mesom kan>oq ri u>pam ja .
Xkunan alaq chwe .	X>kuna>n alaq ch>w>e .
Xintik saqpoʼr ixim che we junabʼ .	X>in>tik saqpoʼr ixim ch>e we junabʼ .
Ri al Ixchel , xuqʼiʼo xa jun akʼ xsipax che .	Ri al Ixchel , x>u>qʼiʼ>o xa jun akʼ x>sipa>x ch>e .
Ri jochʼ kpoqʼowik .	Ri jochʼ k>poqʼow>ik .
Xkilo chi na kinkʼoxomaj taj .	X>k>il>o chi na k>in>kʼoxomaj taj .
Xinwetaʼmaj chi na xatpe taj .	X>inw>etaʼma>j chi na x>at>pe taj .
Rajawaxik ta ne laʼ katchakun wukʼ .	Rajawaxik ta ne laʼ k>at>chakun w>ukʼ .
Nimanel ri akʼal Xwan .	Nimanel ri akʼal Xwan .
E bʼa xincha che areʼ chiʼ xinbʼek .	E bʼa x>in>cha ch>e areʼ chiʼ x>in>bʼe>k .
Jachike ikʼ le unimaqʼij le tinamit Nawaljaʼ ?	Jachike ikʼ le u>nimaqʼij le tinamit Nawaljaʼ ?
Achi xatwilo .	Achi x>at>w>il>o .
Ri uxeʼal ri qatinamit man kasach taj .	Ri u>xeʼal ri qa>tinamit man ka>sach taj .
Kinchaʼ uwach le kinaqʼ .	K>in>chaʼ u>wach le kinaqʼ .
Xas katkʼojiʼ chi upam ri chʼichʼ .	Xas k>at>kʼojiʼ chi u>pam ri chʼichʼ .
Naʼl kayuj ri kinaqʼ rukʼ ri muchʼ .	Naʼl ka>yuj ri kinaqʼ r>ukʼ ri muchʼ .
Sibʼalaj ko rij ri mop .	Sibʼalaj ko r>ij ri mop .
Tzatz ri uqʼanil ri akʼ .	Tzatz ri u>qʼanil ri akʼ .
Kawaj na katʼe taj .	Ka>w>aj na k>at>ʼe taj .
Kej riʼ .	Kej riʼ .
Ri numam are kʼo uqʼinomal .	Ri nu>mam are kʼo u>qʼinomal .
Ri wakax rech ri Luʼs .	Ri wakax r>ech ri Luʼs .
Ri sipojem kʼo chech ri raqan utz chik .	Ri sipojem kʼo ch>ech ri r>aqan utz chik .
Petinaq ri qʼalaj .	Petinaq ri qʼalaj .
Pakʼalik ri a Kuʼ chi uwach ri qʼij .	Pakʼalik ri a Kuʼ chi u>wach ri qʼij .
Kojpetik kolqakʼamaʼ .	K>oj>pet>ik k>ol>qa>kʼam>aʼ .
Jas xojʼe chuloqʼik ?	Jas x>oj>ʼe ch>u>loqʼ>ik ?
Ri ixoq xkamik .	Ri ixoq x>kamik .
Xpuluw ri tʼuʼy pa ri qʼaqʼ .	X>puluw ri tʼuʼy pa ri qʼaqʼ .
La kixwarik ?	La k>ix>war>ik ?
E nitzʼaʼq le taq imul .	E nitzʼ>aʼq le taq imul .
Aj Chi Uwiʼ Miqʼin jaʼ ri Luʼ .	Aj Chi U>wiʼ Miqʼin jaʼ ri Luʼ .
Are kʼut pa le juyubʼ kkʼiy joron , chilaʼ xekikʼama wi ri jaʼ ri winaq .	Are kʼut pa le juyubʼ k>kʼiy joron , chilaʼ x>e>ki>kʼam>a wi ri jaʼ ri winaq .
E kʼi taq le cheʼ tikil chi le bʼe .	E kʼi taq le cheʼ tikil chi le bʼe .
Jas ubʼixik … ?	Jas u>bʼi>x>ik … ?
La katʼe kʼut kabʼij ?	La k>at>ʼe kʼut k>a>bʼij ?
Xinloqʼ ulo jun alanxax rech kaqatijo .	X>in>loqʼ ulo jun alanxax r>ech ka>qa>tij>o .
Jas utzakik le subʼ xuʼano ?	Jas u>tzak>ik le subʼ x>u>ʼan>o ?
Kimbʼe na ka pa le woʼch .	K>im>bʼe na ka pa le w>oʼch .
We kʼo arajil chakʼama la chweʼq .	We kʼo a>rajil ch>a>kʼam>a la chweʼq .
Je riʼ kachakun ri achi .	Je riʼ ka>chaku>n ri achi .
Sibʼalaj at laj na .	Sibʼalaj at laj na .
Xwaj chi xatʼe taj .	X>w>aj chi x>at>ʼe taj .
¿ Jas kibʼiʼ ri winaq ?	¿ Jas ki>bʼiʼ ri winaq ?
Qonojel kujwaʼ pa uwiʼ ri mexa .	Q>onojel k>uj>waʼ pa u>wiʼ ri mexa .
Na xnaʼtaj ta chke chi xeatinik .	Na x>naʼtaj ta ch>k>e chi x>e>atin>ik .
Ri chʼichʼ xubʼan yuk chech ri nupalaj .	Ri chʼichʼ x>u>bʼan yuk ch>ech ri nu>palaj .
Nim uwach ri poʼt .	Nim u>wach ri poʼt .
Rumal ri kʼix , man kewaʼ taj ri winaq .	R>umal ri kʼix , man k>e>waʼ taj ri winaq .
Xretaʼmaj waʼim .	X>r>etaʼma>j waʼ>im .
Kʼakʼ ri upoʼt ri ali .	Kʼakʼ ri u>poʼt ri ali .
Xsikir le waqan .	X>sikir le w>aqan .
Xchʼajtaj qumal .	X>chʼaj>taj q>umal .
Xutaqchiʼj pa waram pulew .	X>u>taqchiʼ>j pa war>am p>ulew .
Pa Saq kʼa jaʼ kbʼan wi ri uq .	Pa Saq kʼa jaʼ k>bʼan wi ri uq .
Are le bʼa xril le ala .	Are le bʼa x>r>il le ala .
Xujbʼe pa jun kʼulanem .	X>uj>bʼe pa jun kʼulanem .
Sibʼalaj jeʼlik ri eqabʼal xubʼan ri Luʼs .	Sibʼalaj jeʼl>ik ri eqabʼal x>u>bʼan ri Luʼs .
We achi we xusipaj jun poʼt chwe xkamik .	We achi we x>u>sipa>j jun poʼt ch>w>e x>kam>ik .
Ri a Wix xuloqʼ rachoch re nimal .	Ri a Wix x>ul>oqʼ r>achoch r>e nimal .
Xsachon chke xatkisikʼij .	X>sachon ch>k>e x>at>kisikʼi>j .
Xinwarik .	X>in>war>ik .
Utz we kaqabʼan jun kʼakʼ nukʼulem .	Utz we ka>qa>bʼan jun kʼakʼ nukʼulem .
Le ali xkunatajik .	Le ali x>kuna>taj>ik .
Su kabʼij la , xubʼij le akʼal che le tat Xoʼr .	Su k>a>bʼij la , x>u>bʼij le akʼal ch>e le tat Xoʼr .
Man kʼo taj rechbʼal xyaʼik .	Man kʼo taj r>echbʼal x>yaʼ>ik .
La xibʼan le ichak ?	La x>i>bʼan le i>chak ?
Jachin rukʼ katbʼe wi ?	Jachin r>ukʼ k>at>bʼe wi ?
Ri nan Toʼn nim winaq chik , saq uwiʼ , ronojel aqʼabʼ utz kunaʼo katʼuyiʼ pa utem , kumiqʼisaj ribʼ cho ri qʼij , kʼo jun uwiʼ umam ubʼiʼ a Teʼk .	Ri nan Toʼn nim winaq chik , saq u>wiʼ , r>onojel aqʼabʼ utz k>u>naʼ>o k>a>tʼuyiʼ pa u>tem , k>u>miqʼisa>j r>ibʼ ch>o ri qʼij , kʼo jun u>wiʼ u>mam u>bʼiʼ a Teʼk .
Nim ri qʼoqʼ .	Nim ri qʼoqʼ .
Tajin kanimaj , ri meʼs .	Tajin k>animaj , ri meʼs .
Qʼeq rij ri amaʼ chij .	Qʼeq r>ij ri amaʼ chij .
Kawaj kinʼek .	Ka>w>aj k>inʼ>ek .
Le ukemik le pas kʼax chawe .	Le u>kem>ik le pas kʼax ch>aw>e .
Konojel ri alabʼomabʼ keʼetzʼanik .	K>onojel ri alabʼom>abʼ k>eʼ>etzʼan>ik .
Jas kajbʼal chanim ?	Jas kajbʼal chanim ?
Kʼakʼ ri achʼichʼ .	Kʼakʼ ri a>chʼichʼ .
Xretaʼmaj uchʼajik .	X>r>etaʼma>j u>chʼaj>ik .
Eleqʼal chʼichʼ .	Eleqʼal chʼichʼ .
Ri kaxlaʼn ik man poqon taj .	Ri kaxlaʼn ik man poqon taj .
La iwir kʼu xril le kʼamol bʼe .	La iwir kʼu x>r>il le kʼamol bʼe .
E kʼo ri ojer taq winaq .	E kʼo ri ojer taq winaq .
Utz chaqe kaqatoʼ qibʼ , taq kʼo kʼaxkʼolil , katewechiʼn ri Ajaw paqawiʼ .	Utz ch>aq>e ka>qa>toʼ q>ibʼ , taq kʼo kʼaxkʼolil , ka>tewechiʼn ri Ajaw pa>qa>wiʼ .
Le uqʼatexik uwach le yabʼilal rajawaxik keqʼatux le e winaq le kiriqom we yabʼilal rukʼ uqʼatuxik le kikʼ chech ukunaxik T.b.g .	Le u>qʼatexik u>wach le yabʼilal rajawaxik k>e>qʼatux le e winaq le ki>riqom we yabʼilal r>ukʼ u>qʼatuxik le kikʼ ch>ech u>kunaxik T.b.g .
Kʼax ri kachʼawik .	Kʼax ri ka>chʼaw>ik .
Pine ta ne kinitzapij pa cheʼ kintor wibʼ .	Pine ta ne k>in>i>tzapi>j pa cheʼ k>in>tor w>ibʼ .
Xaq ta ne kimbʼe iwukʼ .	Xaq ta ne k>im>bʼe iw>ukʼ .
Saqʼor che ri uchak ri achi .	Saqʼor ch>e ri u>chak ri achi .
Kiʼ ri kabʼ .	Kiʼ ri k>abʼ .
Na xwaj taj xinchʼawik .	Na x>w>aj taj x>in>chʼaw>ik .
Jas nu kʼu kuchʼobʼo .	Jas nu kʼu k>u>chʼobʼ>o .
Jas nu kʼu kuchʼobʼo .	Jas nu kʼu k>u>chʼobʼ>o .
Utzalaj winaq ri wixnam .	Utz>alaj winaq ri w>ixnam .
Xuchʼek ronojel le retamanik xpaqiʼk kʼa xkwʼinik xubʼan ajkun .	X>u>chʼek r>onojel le r>etama>n>ik x>paqiʼ>k kʼa x>kwʼin>ik x>u>bʼan ajkun .
Utz we kakʼol ri arajil .	Utz we k>a>kʼol ri a>rajil .
Kabʼan jun toqʼobʼ kyak ri nujal .	K>a>bʼan jun toqʼobʼ k>yak ri nu>jal .
Xepe le winaq xolkikʼama le ali .	X>e>pe le winaq x>ol>ki>kʼam>a le ali .
Jeʼ , tajin kachaponik .	Jeʼ , tajin ka>chapon>ik .
Ajxoʼy ri wikan .	Ajxoʼy ri w>ikan .
Xaq at joʼs .	Xaq at joʼs .
Takʼal le akʼal chlaʼ rech kaqachʼabʼej .	Takʼal le akʼal ch>laʼ r>ech ka>qa>chʼabʼe>j .
Xintij le akʼ .	X>in>tij le akʼ .
¿ Jas che at ajchʼoʼj ?	¿ Jas ch>e at ajchʼoʼj ?
Xintik kajlajkʼal abʼix .	X>in>tik kajlajkʼal abʼix .
Qʼan rij ri atiʼt nukej .	Qʼan r>ij ri atiʼt nu>kej .
Na xeʼe taj na xeʼkiqʼatuj taj .	Na x>e>ʼe taj na x>eʼ>ki>qʼatuj taj .
Pero xinkochʼo xkibʼij tzij chwe , na xinchʼaʼ ta chke .	Pero x>in>kochʼ>o x>ki>bʼij tzij ch>w>e , na x>in>chʼaʼ ta ch>k>e .
Utz ukemik le pas chawe .	Utz u>kem>ik le pas ch>aw>e .
Utz ukemik le pas chawe .	Utz u>kem>ik le pas ch>aw>e .
Kʼo sibʼalaj etaʼmabʼal pa ri Mayabʼ Noʼjibʼal .	Kʼo sibʼalaj etaʼmabʼal pa ri Mayabʼ Noʼjibʼal .
Xkotiʼ ri tzʼiʼ .	X>kotiʼ ri tzʼiʼ .
Roqorik ri ratzʼyaq ri a Xwan .	Roqorik ri r>atzʼyaq ri a Xwan .
Ajkun ri nutat .	Ajkun ri nu>tat .
Maj jabʼ chanim .	Maj jabʼ chanim .
Xbʼe qʼij nan !	X>bʼe qʼij nan !
Ixoq tajin ktchʼabʼexik .	Ixoq tajin k>t>chʼabʼe>x>ik .
Chweʼq kujbʼeʼ pa muquj .	Chweʼq k>uj>bʼeʼ pa muquj .
Saq rij ri plamux .	Saq r>ij ri plamux .
Jas karaj kubʼij … ?	Jas ka>r>aj k>u>bʼi>j … ?
Xepetik xkilo .	X>e>pet>ik x>k>il>o .
At elaqʼom .	At elaqʼom .
Tzʼil ri jaʼ .	Tzʼil ri jaʼ .
Kʼo ulochʼ ri Talin .	Kʼo u>lochʼ ri Talin .
Luʼ ubʼiʼ ri wachalal .	Luʼ u>bʼiʼ ri w>achalal .
Sibʼalaj nim raqan ri kʼamal bʼe .	Sibʼalaj nim r>aqan ri kʼamal bʼe .
Kchʼetet ri jaʼ .	K>chʼetet ri jaʼ .
Kʼo juchʼin chi upam ri tʼuʼy .	Kʼo juchʼin chi u>pam ri tʼuʼy .
Pa ri qʼij Oxlajuj Tijax kinkʼis kebʼ junabʼ kinchakun waral .	Pa ri qʼij Oxlajuj Tijax k>in>kʼis kebʼ junabʼ k>in>chakun waral .
Na kinkʼoxomaj taj jas karaj kubʼij … .	Na k>in>kʼoxoma>j taj jas ka>r>aj k>u>bʼi>j … .
We kabʼan elaqʼ pwaq , kape ri mebʼaʼil pa awiʼ .	We k>a>bʼan elaqʼ pwaq , ka>pe ri mebʼaʼil pa a>wiʼ .
¿ Xayujaʼj ri chʼam rukʼ ri kʼaj ?	¿ X>a>yujaʼ>j ri chʼam r>ukʼ ri kʼaj ?
Kamik man kʼo ta ri tew rumal uj kʼo pa qʼalaj .	Kamik man kʼo ta ri tew r>umal uj kʼo pa qʼalaj .
Kawaj kinbʼij .	K>awaj k>in>bʼij .
Kawaj kinbʼij .	K>awaj k>in>bʼij .
Ktzʼujuw ri rachoch ri Poʼx .	K>tzʼujuw ri r>achoch ri Poʼx .
Xkos le achi .	X>kos le achi .
Ri chʼichʼ kasilabʼik .	Ri chʼichʼ ka>silabʼ>ik .
Tajin kinbʼan le rechaʼ kej .	Tajin k>in>bʼan le r>echaʼ kej .
Xok aqʼabʼ ali !	X>ok aqʼabʼ ali !
Xpe le achi le xinkunaj iwir .	X>pe le achi le x>in>kuna>j iwir .
Ajsik che ri tinamit kel wi ri tataʼ .	Ajsik ch>e ri tinamit k>el wi ri tataʼ .
Xeʼulik .	X>eʼ>ul>ik .
E jobʼ ri winaq .	E jobʼ ri winaq .
Setom ri uwiʼ ri abʼix .	Setom ri u>wiʼ ri abʼix .
Sibʼalaj aninaq kachʼaw le areʼ chinuwach in .	Sibʼalaj aninaq ka>chʼaw le areʼ chi>nu>wach in .
Chaqiʼj ri ulew rumal che man kʼo taj ri jabʼ .	Chaqiʼj ri ulew r>umal ch>e man kʼo taj ri jabʼ .
Ri imul xumaj ri anim , xuya kan le kok .	Ri imul x>u>maj ri anim , x>uya kan le kok .
Jeʼl le tyox .	Jeʼl le tyox .
Kintzalij pa le nutinamit .	K>in>tzalij pa le nu>tinamit .
Xinkunan chech alaq .	X>in>kuna>n ch>ech alaq .
La kʼo jun na kakʼoxomaj taj ?	La kʼo jun na k>a>kʼoxoma>j taj ?
Kattzaq bʼik chi upam ri jul .	K>at>tzaq bʼi>k chi u>pam ri jul .
Chiʼ kewar wi le akʼalabʼ .	Chiʼ k>e>war wi le akʼal>abʼ .
Ri kʼicheʼlaj tajin kkʼisik .	Ri kʼicheʼlaj tajin k>kʼis>ik .
Chʼur ri jochʼ .	Chʼur ri jochʼ .
Xinkunaj alaq .	X>in>kuna>j alaq .
We ta xatbʼe wukʼ pa le tinamit , xaloqʼ ta laʼ le ujastaq le akʼajol .	We ta x>at>bʼe w>ukʼ pa le tinamit , x>a>loqʼ ta laʼ le u>jastaq le a>kʼajol .
Xinloqʼ jun kʼakʼ patan .	X>in>loqʼ jun kʼakʼ patan .
Na utz ta le utʼisom le al Mariy .	Na utz ta le u>tʼisom le al Mariy .
Tajin kamusmutik .	Tajin ka>musmut>ik .
Maj sutzʼ iwir .	Maj sutzʼ iwir .
Xiʼnwilaʼ .	X>iʼ>nw>il>aʼ .
Kʼo ri chʼip pa uwiʼ ri xot .	Kʼo ri chʼip pa u>wiʼ ri xot .
Xtzaq ri rachoch rumal ri jabʼ .	X>tzaq ri r>achoch r>umal ri jabʼ .
Naqaj at kʼo wi chi wech .	Naqaj at kʼo wi chi w>ech .
Aʼre e tijoxelabʼ .	Aʼre e tijoxel>abʼ .
Ri joj kabʼisonik rumal che maj chik kutijo .	Ri joj ka>bʼison>ik r>umal ch>e maj chik k>u>tij>o .
Na kinbʼe ta pa le nimatijobʼal rumal xinkosik .	Na k>in>bʼe ta pa le nimatijobʼal r>umal x>in>kos>ik .
Xojpetik xolqakʼamaʼ .	X>oj>pet>ik x>ol>qa>kʼam>aʼ .
Xojpetik xolqakʼamaʼ .	X>oj>pet>ik x>ol>qa>kʼam>aʼ .
Xojpetik xolqakʼamaʼ .	X>oj>pet>ik x>ol>qa>kʼam>aʼ .
Kʼo jun tzʼiʼ pa bʼe .	Kʼo jun tzʼiʼ pa bʼe .
E kʼo ri qachalal pa Chi uwiʼ la .	E kʼo ri q>achalal pa Chi u>wiʼ la .
Ri chʼuʼ ktij rukʼ lej .	Ri chʼuʼ k>tij r>ukʼ lej .
Ri qʼutuʼm man kech ta le akʼalabʼ .	Ri qʼutuʼm man k>ech ta le akʼal>abʼ .
Ri achi kbʼek pa utuj juyubʼ .	Ri achi k>bʼe>k pa u>tuj juyubʼ .
Kinkoj ri jokbʼal ulew .	K>in>koj ri jokbʼal ulew .
In in kʼo pa tijobʼal .	In in kʼo pa tijobʼal .
La kixpe pa tijobʼal ?	La k>ix>pe pa tijobʼal ?
Xubʼij chwe jawi at kʼo wi .	X>u>bʼij ch>w>e jawi at kʼo wi .
Jachin xawilo chi are xtijow ri tiʼj ?	Jachin x>aw>il>o chi are x>tij>ow ri tiʼj ?
Kakaj le akʼalabʼ kewaʼik .	Ka>k>aj le akʼal>abʼ k>e>waʼ>ik .
Junam kijunabʼ .	Junam ki>junabʼ .
Xqaxiʼj qibʼ xqachapo .	X>qa>xiʼj q>ibʼ x>qa>chap>o .
Nim ri ja .	Nim ri ja .
In chajinel kech le akʼalabʼ .	In chajinel k>ech le akʼal>abʼ .
Rajawaxik ri akʼalabʼ kikinimaj kitzij le kinan , kitat .	Rajawaxik ri akʼal>abʼ ki>ki>nimaj ki>tzij le ki>nan , ki>tat .
Kʼi tinamit e kʼo pa chʼoʼj .	Kʼi tinamit e kʼo pa chʼoʼj .
Man yaʼtal taj chi awe katok pa ja .	Man yaʼtal taj chi aw>e ka>to>k pa ja .
La xinutzukuj le tijoxel ?	La x>in>u>tzuku>j le tijoxel ?
Jumuchʼ ri nujunabʼ .	Jumuchʼ ri nu>junabʼ .
Xintijo .	X>in>tij>o .
Jas ubʼanom le nuchʼutitat ?	Jas u>bʼan>om le nu>chʼutitat ?
Kʼo pwaq pa uwiʼ ri mexa .	Kʼo pwaq pa u>wiʼ ri mexa .
Utz uchomanik ri ali .	Utz u>chomanik ri ali .
In ajtij ; at tijoxel .	In ajtij ; at tijoxel .
Xsachon chke chi xeatinik .	X>sachon ch>k>e chi x>e>atin>ik .
Xsachon chke chi xeatinik .	X>sachon ch>k>e chi x>e>atin>ik .
E janipa le awalkʼwal e kʼolik ?	E janipa le awalkʼwal e kʼol>ik ?
Jatʼim kanoq ri kej .	Jatʼim kan>oq ri kej .
I xumin ruʼjolom riʼ rtzʼiʼ i na xtzoqopitaj ta chuʼloq .	I x>u>min r>uʼ>jolom riʼ r>tzʼiʼ i na x>tzoqopi>taj ta ch>uʼloq .
Are taq kinkosik kinwarik .	Are taq k>in>kos>ik k>in>war>ik .
Are taq qʼaxinaq chi kʼi uwuq qʼij on kʼi ikʼ kumajij le ukabʼ ukʼutunik rukʼ taq sachem , man kʼo ta chi uchʼobʼolik , umokʼokʼem chiʼl man kabʼan ta chi waram .	Are taq qʼaxinaq chi kʼi uwuq qʼij on kʼi ikʼ k>u>maji>j le ukabʼ u>kʼutunik r>ukʼ taq sachem , man kʼo ta chi u>chʼobʼolik , u>mokʼokʼem chiʼl man ka>bʼan ta chi waram .
Kʼo jubʼiqʼ awech .	Kʼo jubʼiqʼ aw>ech .
Ri saqʼos tajin kkamik .	Ri saqʼos tajin k>kamik .
Chom ri aq .	Chom ri aq .
Kʼo oxlajuj ujunabʼ ri numiʼal .	Kʼo oxlajuj u>junabʼ ri nu>miʼal .
Chʼaqal chik ri watzʼyaq .	Chʼaqal chik ri w>atzʼyaq .
Ri roqʼej ri ali jacha kpe jun akʼal .	Ri r>oqʼej ri ali jacha k>pe jun akʼal .
Kinchʼaw rukʼ le nunan pa le chʼawebʼal .	K>in>chʼaw r>ukʼ le nu>nan pa le chʼawebʼal .
Ix ix eʼlaqʼomabʼ !	Ix ix eʼ>laqʼom>abʼ !
Kabʼixik chi 30.000 e winaq kiriqom we yabʼilal , rukʼ 7.000 kʼakʼ taq yabʼil pa ri junabʼ 2012 .	Ka>bʼi>x>ik chi 30.000 e winaq ki>riq>om we yabʼilal , r>ukʼ 7.000 kʼakʼ taq yabʼil pa ri junabʼ 2012 .
Ri unan kukʼol ronojel we jastaq riʼ pa ri ranimaʼ .	Ri u>nan k>u>kʼol r>onojel we jastaq riʼ pa ri r>animaʼ .
Kcholol ri achachal .	K>cholol ri a>chachal .
Kinbʼisoj uwach le wal .	K>in>bʼiso>j u>wach le w>al .
Xinqʼiʼo takʼalik xinpetik .	X>in>qʼiʼ>o takʼalik x>in>pet>ik .
Xkʼotochin chi kiwach chi kinwaʼ awukʼ .	X>kʼotochin chi ki>wach chi k>in>waʼ aw>ukʼ .
Man kʼo taj ukʼisik ri mayabʼ ajlabʼalil .	Man kʼo taj u>kʼisik ri mayabʼ ajlabʼalil .
La kawaj kʼut katʼek ?	La k>aw>aj kʼut k>at>ʼe>k ?
Jas nu kʼu kuchʼobʼ sin kanma ...	Jas nu kʼu k>u>chʼobʼ sin k>anma ...
Xepetik rech kewaʼ iwukʼ .	X>e>pet>ik rech k>e>waʼ iw>ukʼ .
Pusum ri kaxlaʼn wa wa .	Pusum ri kaxlaʼn wa wa .
Kkoj kan retal chi uwach ri ulew .	K>koj kan r>etal chi u>wach ri ulew .
Jeʼl kunaʼ ri abʼix chi upam ri quq ulew .	Jeʼl k>u>naʼ ri abʼix chi u>pam ri quq ulew .
Ma xinel ta chi el pa bʼe .	Ma x>in>el ta chi el pa bʼe .
Pa le nimaqʼij rajawaxik kawiq le ja .	Pa le nimaqʼij rajawaxik ka>wiq le ja .
Kʼakʼ ri wachoch .	Kʼakʼ ri w>achoch .
Saq rij ri chij .	Saq r>ij ri chij .
Kʼax le nuqʼabʼ .	Kʼax le nu>qʼabʼ .
Kinya waʼ we chʼichʼ pinemna utz .	K>in>ya waʼ we chʼichʼ pine>mna utz .
Qʼinom ri achi .	Qʼinom ri achi .
Le ukunatajem are rukʼ utzukuxik le uchikopil pa jun usolik uxeʼ le kikʼ on le jaʼ rech jun nodo .	Le u>kunatajem are r>ukʼ u>tzukuxik le u>chikopil pa jun u>solik u>xeʼ le kikʼ on le jaʼ r>ech jun nodo .
Ko kikʼoʼxal ri top .	Ko ki>kʼoʼxal ri top .
Sibʼalaj nim ri noʼs .	Sibʼalaj nim ri noʼs .
Kʼo jun kuk ubʼiʼ Tintin , waʼ le laj kuk mam kajeqi taj , kapaqi kaxulik pa uwiʼ uqʼabʼ taq cheʼ , sibʼalaj sakʼaj , keʼuto le enimaʼq , chʼutin , rachiʼl , ajsipanel sibʼalaj utz ranimaʼ .	Kʼo jun kuk u>bʼiʼ Tintin , waʼ le laj kuk mam ka>jeqi taj , ka>paqi ka>xul>ik pa u>wiʼ uqʼabʼ taq cheʼ , sibʼalaj sakʼaj , k>eʼ>u>to le e>nim>aʼq , chʼutin , r>achiʼl , aj>sipanel sibʼalaj utz r>animaʼ .
Iwir xujtzalij la pa kʼaybʼal .	Iwir x>uj>tzalij la pa kʼaybʼal .
Ri nunan xbʼe pa kʼaybʼal .	Ri nu>nan x>bʼe pa kʼaybʼal .
Jeʼ , xinloqʼo .	Jeʼ , x>in>loqʼ>o .
Kʼo sibʼalaj uwach ri ucheʼal oj .	Kʼo sibʼalaj u>wach ri u>cheʼal oj .
Pachaʼ ri Niʼl kkʼayik .	Pachaʼ ri Niʼl k>kʼay>ik .
Na utzakik ta subʼ tajin kuʼano .	Na u>tzak>ik ta subʼ tajin k>u>ʼan>o .
Are le bʼa xokik .	Are le bʼa x>ok>ik .
Kʼo reqaʼn ri abʼix .	Kʼo r>eqaʼn ri abʼix .
La katzalij luʼla aninaq ?	La ka>tzalij luʼ>la aninaq ?
Chuxe le qachomal kaqatij wi jun qameqʼin .	Ch>u>xe le qa>chomal ka>qa>tij wi jun qameqʼin .
Tajin ksikʼow ri akʼ .	Tajin k>sikʼow ri akʼ .
Xchapik .	X>chap>ik .
Katchʼaw chi rij awachalal .	K>at>chʼaw chi r>ij aw>achalal .
Ri Simon e ri erachiʼl kkiterneʼbʼej ubʼi ri areʼ .	Ri Simon e ri e>r>achiʼl k>ki>terneʼbʼej u>bʼi ri areʼ .
Kubʼan le wa rech le nukʼulanem .	K>u>bʼan le wa r>ech le nu>kʼulanem .
Ri ala nim kril wi ri umam .	Ri ala nim k>r>il wi ri u>mam .
Paqʼom chik ri siʼ .	Paqʼom chik ri siʼ .
E kʼo kajibʼ akʼalabʼ pa le bʼe .	E kʼo kajibʼ akʼal>abʼ pa le bʼe .
Jas xkiyako xata ?	Jas x>ki>yak>o x>a>ta ?
Xuchap nukunaxik .	X>u>chap nu>kuna>x>ik .
... kinbʼij chi are waʼ sin xiʼan .	... k>in>bʼij chi are waʼ sin x>i>ʼan .
Xojʼek xeʼqilala rqasok .	X>oj>ʼe>k x>eʼ>q>il>a>la r>qa>sok .
Xojʼek xeʼqilala rqasok .	X>oj>ʼe>k x>eʼ>q>il>a>la r>qa>sok .
Xojʼek xeʼqilala rqasok .	X>oj>ʼe>k x>eʼ>q>il>a>la r>qa>sok .
Ri alaj ali Siʼl xubʼij xqachap pa utzal ri Tyox .	Ri alaj ali Siʼl x>u>bʼij x>qa>chap pa u>tzal ri Tyox .
Xopan le wuj awukʼ rumal wech in .	X>opan le wuj aw>ukʼ r>umal w>ech in .
Xopan le wuj awukʼ rumal wech in .	X>opan le wuj aw>ukʼ r>umal w>ech in .
Maj urajil le qʼabʼarel .	Maj u>rajil le qʼabʼarel .
Are rintat xilowik , in , na xinwil taj .	Are r>in>tat x>il>ow>ik , in , na x>inw>il taj .
Are rintat xilowik , in , na xinwil taj .	Are r>in>tat x>il>ow>ik , in , na x>inw>il taj .
Qʼeʼlik , ri chaj pa ri bʼe .	Qʼeʼlik , ri chaj pa ri bʼe .
Are le utat le al Skaʼ .	Are le u>tat le al Skaʼ .
Xkʼis ri nutzijonem .	X>kʼis ri nu>tzijonem .
Jas chemna kixpe chweʼq ?	Jas ch>e>mna k>ix>pe chweʼq ?
Ri nan Lol xpochʼ che ri upam .	Ri nan Lol x>pochʼ ch>e ri u>pam .
Ri kotzʼiʼj kqakoj chi upam ri ja .	Ri kotzʼiʼj k>qa>koj chi u>pam ri ja .
Le ukemik le pas aninaq ( awumal ) .	Le u>kem>ik le pas aninaq ( aw>umal ) .
Kʼo jun xaʼr pa ja .	Kʼo jun xaʼr pa ja .
La utz awach ? - Utz maltyox , e kʼu ri at ? – Utz maltyox .	La utz a>wach ? - Utz maltyox , e kʼu ri at ? – Utz maltyox .
Chatan loq ali .	Ch>at>an loq ali .
Kʼo jun qatʼuʼy pa ja !	Kʼo jun qa>tʼuʼy pa ja !
Inriqtajinaq pa ri kʼayibʼal .	In>riqtajinaq pa ri kʼayibʼal .
Ri imox jun che ri Mayabʼ Cholqʼij .	Ri imox jun ch>e ri Mayabʼ Cholqʼij .
Jas che xechaqij le abʼix ?	Jas ch>e x>e>chaqij le abʼix ?
Are sibʼalaj kaq le apoʼt chuwach le nupoʼt .	Are sibʼalaj kaq le a>poʼt ch>u>wach le nu>poʼt .
Ri ixoq ri xpe Chwitzʼaq xulik .	Ri ixoq ri x>pe Chwitzʼaq x>ul>ik .
Xok aqʼabʼ !	X>ok aqʼabʼ !
Pim ruq , ri ali .	Pim r>uq , ri ali .
Katela !	K>at>el>a !
xumajij oqʼej le nan .	x>u>maji>j oqʼej le nan .
Che le salwaʼt kbʼan kaxlaʼn wa wa .	Ch>e le salwaʼt k>bʼan kaxlaʼn wa wa .
Aqʼabʼ xwalijik le unan le ala , xubʼan ri ulej , jun saqmol pa ri xot , xutzir uwa ri a Tiʼx .	Aqʼabʼ x>walij>ik le u>nan le ala , x>u>bʼan ri u>lej , jun saqmol pa ri xot , x>utzir u>wa ri a Tiʼx .
We wonon xubʼij chike : - kixinto .	We wonon x>u>bʼij chi>k>e : - k>ix>in>to .
Kʼakʼ le nupoʼt .	Kʼakʼ le nu>poʼt .
Matbʼinik .	M>at>bʼin>ik .
Matbʼinik .	M>at>bʼin>ik .
Ri qʼayes kjaʼjat uwach .	Ri qʼayes k>jaʼjat u>wach .
Xekos le tzʼiʼ .	X>e>kos le tzʼiʼ .
We kamik kʼo chik Tyox ja , xuqujeʼ kʼo chik kaxlan qʼaqʼ .	We kamik kʼo chik Tyox ja , xuqujeʼ kʼo chik kaxlan qʼaqʼ .
Le ukunaxik le nabʼe ukʼutunik are rukʼ taq kunabʼal pentamidina on suramina .	Le u>kunaxik le nabʼe u>kʼutunik are r>ukʼ taq kunabʼal pentamidina on suramina .
Sibʼalaj al ri weqaʼn .	Sibʼalaj al ri w>eqaʼn .
Aʼre e ral le nan Weʼl .	Aʼre e r>al le nan Weʼl .
Ri qʼosbʼal rech kʼisis .	Ri qʼosbʼal r>ech kʼisis .
Xinnabʼej chutasik qakʼolibʼal .	X>in>nabʼej ch>u>tas>ik qa>kʼolibʼal .
Xretaʼmaj awilik .	X>r>etaʼma>j aw>il>ik .
Tajin kchakun ri ala .	Tajin k>chakun ri ala .
Xsachon chwe xinatinik .	X>sachon ch>w>e x>in>atin>ik .
Are kayoʼw le uchikopil le ubʼantajik Trypanosoma brucei .	Are ka>yoʼw le u>chikopil le u>bʼantajik Trypanosoma brucei .
We ne xatkowin ta laʼ xatbʼe rukʼ le al Talin .	We ne x>at>kowin ta laʼ x>at>bʼe r>ukʼ le al Talin .
Nojinaq ri kʼolibʼal mes .	Nojinaq ri kʼolibʼal mes .
Kʼax nuqul .	Kʼax nu>qul .
Kʼo qʼol chi rij ri siʼ .	Kʼo qʼol chi r>ij ri siʼ .
Xutʼuyubʼaʼ .	X>u>tʼuy>ubʼaʼ .
Qetaʼm che ri qawa kujutoʼo .	Q>etaʼm ch>e ri qa>wa k>uj>u>toʼ>o .
Ri utzilal kpetik are taq junam kbʼan chech le qʼatbʼal tzij .	Ri utzilal k>pet>ik are taq junam k>bʼan ch>ech le qʼatbʼal tzij .
Ri witzikʼ tajin kpe loq .	Ri witzikʼ tajin k>pe loq .
At at utaqoʼn le qʼatal tzij .	At at u>taqoʼn le qʼatal tzij .
Kabʼison ri Leʼn .	Ka>bʼison ri Leʼn .
Chʼutiʼn kekanaj ri xajabʼ chech .	Chʼutiʼn k>e>kanaj ri xajabʼ ch>ech .
Jeʼlik ktijow ri taq ikox .	Jeʼl>ik k>tijow ri taq ikox .
Man e kʼi taj ri naʼoj tzʼibʼ .	Man e kʼi taj ri naʼoj tzʼibʼ .
In ajchʼajal chichʼ .	In ajchʼajal chichʼ .
Ponopik ri a Kuʼ .	Ponopik ri a Kuʼ .
Xatqaj chi upam ri il .	X>at>qaj chi u>pam ri il .
Ri qʼuqʼ are jun jeʼl chikop .	Ri qʼuqʼ are jun jeʼl chikop .
Xinsachik .	X>in>sach>ik .
Xinsachik .	X>in>sach>ik .
Paʼtz rij ri tzʼiʼ .	Paʼtz r>ij ri tzʼiʼ .
Kintij na .	K>in>tij na .
Na xqabʼan taj .	Na x>qa>bʼan taj .
Man are ta rala xkosik .	Man are ta r>ala x>kos>ik .
Iwech chi jujunal , ri wa .	Iw>ech chi jujunal , ri wa .
Ri sanik keʼel loq pa qʼalaj .	Ri sanik k>eʼ>el loq pa qʼalaj .
Nim chak xbʼan chiʼ rumal sibʼalaj kabʼe kikʼuʼx che rutzilal le komon .	Nim chak x>bʼan chiʼ r>umal sibʼalaj ka>bʼe ki>kʼuʼx ch>e r>utzilal le komon .
Kebʼe pa waʼim .	K>e>bʼe pa waʼ>im .
Na kujwar taj .	Na k>uj>war taj .
Ri aliʼ Poʼx , utzalaj ajtijoxel , kʼax taj kubʼan che usikʼixik uwach wuj .	Ri aliʼ Poʼx , utz>alaj aj>tijoxel , kʼax taj k>u>bʼan ch>e u>sikʼi>x>ik u>wach wuj .
Are ri ali xojilow kanoq .	Are ri ali x>oj>il>ow kan>oq .
Sibʼalaj utz kinwil le atzʼyaq rech Nahuala .	Sibʼalaj utz k>inw>il le atzʼyaq r>ech Nahuala .
Xawilo , xqʼatan le ibʼoy .	X>aw>il>o , x>qʼatan le ibʼoy .
Xintij mukun iwir .	X>in>tij mukun iwir .
Nim raqan ri tux kelik .	Nim r>aqan ri tux k>el>ik .
Xretaʼmaj chi rukʼ pakʼ kutij wi .	X>r>etaʼma>j chi r>ukʼ pakʼ k>u>tij wi .
Ri sikil ktijow rukʼ ik .	Ri sikil k>tijow r>ukʼ ik .
Are man kʼax ta ukunaxik are taq aninaq kaʼilitaj we yabʼilal xuqujeʼ mojoʼqa kuyaʼ le kʼaxkʼolil chech le jolomaj .	Are man kʼax ta u>kunaxik are taq aninaq kaʼilitaj we yabʼilal xuqujeʼ mojoʼqa k>u>yaʼ le kʼaxkʼolil ch>ech le jolom>aj .
Xintoʼtaj che ri nuchak .	X>in>toʼtaj ch>e ri nu>chak .
¿ La katbʼe kukʼ ri awalkʼwaʼl ?	¿ La k>at>bʼe k>ukʼ ri awalkʼwaʼl ?
Tajin kamuxan ri awecham .	Tajin ka>muxan ri aw>echam .
Ri Luʼs Yaxon kʼo oxibʼ uwakax nimaʼq .	Ri Luʼs Yaxon kʼo oxibʼ u>wakax nim>aʼq .
Waʼ kumajij chi jun uwuq on urox uwuq qʼij are taq xtiʼ le winaq .	Waʼ k>u>maji>j chi jun uwuq on urox uwuq qʼij are taq x>tiʼ le winaq .
Kaqatijo .	Ka>qa>tij>o .
Ri tʼuʼy kpaqʼowik .	Ri tʼuʼy k>paqʼ>ow>ik .
Xinwilo chi xeʼelik .	X>inw>il>o chi x>eʼ>el>ik .
Man e kʼi taj ri qulaʼ .	Man e kʼi taj ri q>ulaʼ .
Ri alaj a Xep kʼo pa ri nabʼe tijonem .	Ri alaj a Xep kʼo pa ri nabʼe tijonem .
Pa ri waʼbʼal e kʼo kawinaq achijabʼ .	Pa ri waʼbʼal e kʼo kawinaq achij>abʼ .
Sibʼalaj utz che ri wiʼaj ri tuney .	Sibʼalaj utz ch>e ri wiʼ>aj ri tuney .
Xinkosik rumal xinchakunik	X>in>kos>ik r>umal x>in>chakun>ik
Are laʼ kinchakuj .	Are laʼ k>in>chaku>j .
In loqʼomanel re ixim .	In loqʼomanel r>e ixim .
Are utz unaʼoj .	Are utz u>naʼoj .
Xinpe pa taqʼaj .	X>in>pe pa taqʼaj .
Ktoqʼon ri moʼch .	K>toqʼon ri moʼch .
Are ta xiwaj xixbʼixanik par na utz ta le iqul .	Are ta x>iw>aj x>ix>bʼixa>n>ik par na utz ta le i>qul .
Chel ubʼik nabʼe ri awajibʼ kʼa te kʼu riʼ ri e winaq .	Ch>el ubʼik nabʼe ri awaj>ibʼ kʼa te kʼu riʼ ri e winaq .
Wemna chpe le jabʼ kakam le abʼix .	We>mna ch>pe le jabʼ ka>kam le abʼix .
le itzela winaq .	le itzel>a winaq .
Xateʼqilaʼ .	X>at>eʼ>q>il>aʼ .
We ta kape le jabʼ kamik .	We ta ka>pe le jabʼ kamik .
kyitzʼitzʼ ri nupam rumal ri kinaqʼ .	k>yitzʼitzʼ ri nu>pam r>umal ri kinaqʼ .
Kʼo qoʼch chilaʼ Nawaljaʼ .	Kʼo q>oʼch chilaʼ Nawaljaʼ .
Ktij ri uwaʼl ik rumal ri kinimaqʼij .	K>tij ri u>waʼl ik r>umal ri ki>nimaqʼij .
Jas upatan le tzij … ?	Jas u>patan le tzij … ?
Rajwaxik keqyaʼ uqʼij ri qajaw .	Rajwaxik k>e>q>yaʼ u>qʼij ri q>ajaw .
We kʼo jun ktzaqik ¿ la man kinporoj ta wibʼ ri in ?	We kʼo jun k>tzaq>ik ¿ la man k>in>poroj ta w>ibʼ ri in ?
Kinqʼojomanik .	K>in>qʼojoma>n>ik .
Pa qatinamit kujtzijon pa Kʼicheʼ chʼabʼal .	Pa qa>tinamit k>uj>tzijon pa Kʼicheʼ chʼabʼal .
Ri yoʼx taq akʼalabʼ kekikʼux ri atzʼyaq .	Ri yoʼx taq akʼal>abʼ k>e>ki>kʼux ri atzʼyaq .
Xqasikʼij le ixoq chutzakik subʼ .	X>qa>sikʼi>j le ixoq ch>u>tzak>ik subʼ .
Jeʼl kʼolem chi awachoch .	Jeʼl kʼolem chi aw>achoch .
Tripanosomiasis africana on yabʼilal rech waram are jun uchikopil yabʼil kech e winaq chiʼl awajibʼ .	Tripanosomiasis africana on yabʼilal r>ech waram are jun u>chikopil yabʼil k>ech e winaq chiʼl awaj>ibʼ .
Sibʼalaj mox ri ali .	Sibʼalaj mox ri ali .
Are waʼ .	Are waʼ .
We ta ma ta xatbʼe pa le tinamit ma ta xaloqʼ laʼ le ujastaq le akʼajol .	We ta ma ta x>at>bʼe pa le tinamit ma ta x>a>loqʼ laʼ le u>jastaq le a>kʼajol .
Utz we kiwetaʼmaj jas kubʼij ri cholbʼal qʼij .	Utz we ki>w>etaʼma>j jas k>u>bʼij ri cholbʼal qʼij .
Xutaʼ sachbʼal umak che ri unan .	X>u>taʼ sachbʼal u>mak ch>e ri u>nan .
La katbʼin pa le uxlanbʼal ?	La k>at>bʼin pa le uxlanbʼal ?
Nabʼe : kbʼan ri chʼam rukʼ jutzʼit kʼaj .	Nabʼe : k>bʼan ri chʼam r>ukʼ jutzʼit kʼaj .
Ronojel xinbʼij chi awe saqalaj tzij .	R>onojel x>in>bʼij chi aw>e saqalaj tzij .
¿ La utz wach la ?	¿ La utz wach la ?
Xukʼaq bʼi jun abʼaj rech kixkil loq .	X>u>kʼaq bʼi jun abʼaj r>ech k>ix>k>il loq .
Xesikʼixik , kʼate kʼuriʼ xeyajik , xuqujeʼ xetaq bʼi che usikʼik le mes .	X>e>sikʼi>x>ik , kʼate kʼuriʼ x>e>yaj>ik , xuqujeʼ x>e>taq bʼi ch>e u>sikʼ>ik le mes .
Xepetik xolkikʼamaʼ .	X>e>pet>ik x>ol>ki>kʼam>aʼ .
Xinya kan le nuchim pa kʼaybʼal .	X>in>ya kan le nu>chim pa kʼaybʼal .
Utukel kakanaj kan pa ja .	U>tukel ka>kanaj kan pa ja .
Tajin Kinjokʼ ri ubʼaqʼ le qʼoqʼ .	Tajin K>in>jokʼ ri u>bʼaqʼ le qʼoqʼ .
Sibʼalaj kʼaʼn ri ajiʼ .	Sibʼalaj kʼaʼn ri a>jiʼ .
Moʼr kkaʼy ri nuchʼichʼ .	Moʼr k>kaʼy ri nu>chʼichʼ .
We ta ma ta xinawilo ma ta kinya bʼe laʼ chawech .	We ta ma ta x>in>aw>il>o ma ta k>in>ya bʼe laʼ ch>aw>ech .
Kʼo jun qʼoxowem chi we .	Kʼo jun qʼoxowem chi w>e .
Kiqʼat ri kʼim .	Ki>qʼat ri kʼim .
Ri Pal sibʼalaj saqʼor .	Ri Pal sibʼalaj saqʼor .
Ri Xpeʼr qajanel pwaq .	Ri Xpeʼr qajanel pwaq .
Ajpatan ri Teʼk .	Ajpatan ri Teʼk .
Kematzʼibʼ .	Kematzʼibʼ .
Tajin katjilow che uqʼoxom jolomaj .	Tajin k>at>jilow ch>e u>qʼoxom jolom>aj .
Qʼalaj che kʼo utzwachil ri numam .	Qʼalaj ch>e kʼo utzwachil ri nu>mam .
Jeʼl ktijow ri aj .	Jeʼl k>tijow ri aj .
Ri joj xukʼam bʼik ri akʼ .	Ri joj x>u>kʼam bʼi>k ri akʼ .
Ri tikonel man kpe taj .	Ri tikonel man k>pe taj .
Kuqamuj ujoron ri ajtzij .	K>u>qamu>j u>joron ri ajtzij .
- ¡ Ay ! Xa xintzaq uloq , kʼax we waqan .	- ¡ Ay ! Xa x>in>tzaq uloq , kʼax we w>aqan .
Xuqʼiʼo xkamsax ri rachalal choch .	X>u>qʼiʼ>o x>kamsa>x ri r>achalal ch>och .
Xwaj xinʼek .	X>w>aj x>in>ʼek .
Xkikʼut chi uwach ri ajtij xuqujeʼ chikiwach ri taq nikʼaj kachil .	X>ki>kʼut chi u>wach ri aj>tij xuqujeʼ chi>ki>wach ri taq nikʼaj k>achil .
Qʼoʼm ri upas ri Poʼx .	Qʼoʼm ri u>pas ri Poʼx .
Xkichap tojonik .	X>ki>chap toj>on>ik .
Xraj katʼek .	X>r>aj k>at>ʼe>k .
Ktijow ri utiʼjolal ri ixpum .	K>tijow ri u>tiʼjolal ri ix>pum .
Xnimar uwach ri nimaʼ .	X>nimar u>wach ri nimaʼ .
Kakʼal ujunabʼ ri nunan .	K>akʼal u>junabʼ ri nu>nan .
Kwaj che ix kixbʼanowik .	K>w>aj ch>e ix k>ix>bʼan>ow>ik .
Sibʼalaj nim le tinamit .	Sibʼalaj nim le tinamit .
Pinemna kabʼe le watz , kimbʼe wi in pa kaʼyibʼal .	Pine>mna ka>bʼe le w>atz , k>im>bʼe wi in pa kaʼyibʼal .
Xa rumal karaj kretaʼmaj unikʼoxik xuqujeʼ utzʼibʼaxik uwach wuj , utz karil le etzʼanem xuqujeʼ le bʼix .	Xa r>umal ka>r>aj k>r>etaʼma>j u>nikʼo>x>ik xuqujeʼ u>tzʼibʼa>x>ik u>wach wuj , utz ka>r>il le etzʼanem xuqujeʼ le bʼix .
Ri ali Naʼ kakiʼkotik are taq xrilo chi le laj tzʼunun xbʼe pa uwiʼ le jeʼl taq kotzʼiʼj .	Ri ali Naʼ ka>kiʼkot>ik are taq x>r>il>o chi le laj tzʼunun x>bʼe pa u>wiʼ le jeʼl taq kotzʼiʼj .
Pa le jun ikʼ chik are nimaqʼij .	Pa le jun ikʼ chik are nimaqʼij .
Ronojel le ulew ech alaq .	R>onojel le ulew ech alaq .
Sakʼal ri Pal che we chak .	Sakʼal ri Pal ch>e we chak .
Wajxaqlajuj ujunabʼ ri numiʼal .	Wajxaqlajuj u>junabʼ ri nu>miʼal .
Xa rumal ketaʼm konojel ri winaq kkiqumuj le jaʼ .	Xa r>umal k>etaʼm k>onojel ri winaq k>ki>qumu>j le jaʼ .
Na xinta taj we kixkitzuqu .	Na x>in>ta taj we k>ix>ki>tzuq>u .
Xkunataj le ali ( kumal ri ixoqibʼ ) .	X>kuna>taj le ali ( k>umal ri ixoq>ibʼ ) .
Ri Awel xretaʼmaj chi rajawaxik man kuxej ta ribʼ che ri tukur .	Ri Awel x>r>etaʼma>j chi rajawaxik man k>u>xej ta r>ibʼ ch>e ri tukur .
Latzʼ uwach ri ajchak .	Latzʼ u>wach ri ajchak .
Kʼax riʼ ri kachʼawik .	Kʼax riʼ ri ka>chʼaw>ik .
Kinbʼe na kukʼ ri molaj .	K>in>bʼe na k>ukʼ ri molaj .
Kinchakunik rech katwaʼik .	K>in>chakun>ik r>ech k>at>waʼ>ik .
Rajawaxik kjikik ri waqan .	Rajawaxik k>jik>ik ri w>aqan .
Ronojel qʼij kachakun ri Toʼn .	R>onojel qʼij ka>chakun ri Toʼn .
Ri akʼal xsach kanoq je laʼ pa taqʼaj .	Ri akʼal x>sach kan>oq je laʼ pa taqʼaj .
Kutʼis ri pantalon .	K>u>tʼis ri pantalon .
Xintzaq nulawe .	X>in>tzaq nu>lawe .
Xuta we katʼek .	X>u>ta we k>at>ʼe>k .
Ri a Teʼk xumaltyoxij che ri ratiʼt , rumal ri utzalaj noʼjibʼal xukʼut chech .	Ri a Teʼk x>u>maltyoxij ch>e ri r>atiʼt , r>umal ri utz>alaj noʼjibʼal x>u>kʼut ch>ech .
Kawaj kinʼek .	Ka>w>aj k>in>ʼek .
Kinyaʼ nukuchubʼal .	K>in>yaʼ nu>kuchubʼal .
Xuta le nimalaj kʼamol bʼe rech we tinamit chi xuʼl le ajtijabʼ .	X>u>ta le nim>alaj kʼamol bʼe r>ech we tinamit chi x>uʼl le ajtij>abʼ .
Kwaʼ chi uwach le taqʼaj ri amaʼ akʼ .	K>waʼ chi u>wach le taqʼaj ri amaʼ akʼ .
Rax taq le kotzʼiʼj .	Rax taq le kotzʼiʼj .
Kasumum ri kaqiqʼ .	Ka>sumum ri kaqiqʼ .
Jun qʼuʼq rajil ri kaxlaʼn wa .	Jun qʼuʼq rajil ri kaxlaʼn wa .
Man xkitij ta le tzʼiʼ .	Man x>ki>tij ta le tzʼiʼ .
Man pa kʼayibʼal ta xutijo .	Man pa kʼayibʼal ta x>u>tij>o .
Jas xsachon chqe xqachʼajo .	Jas x>sachon ch>q>e x>qa>chʼaj>o .
Kʼo rachalal pa Tzʼoloj cheʼ ri Peʼl .	Kʼo r>achalal pa Tzʼoloj cheʼ ri Peʼl .
Oj ajxojolobʼ pa Awas Qʼij .	Oj ajxojolobʼ pa Awas Qʼij .
Xopan jun wonon , xutaʼ chike : - jas che kixoqʼik .	X>opan jun wonon , x>u>taʼ chi>k>e : - jas ch>e k>ix>oqʼ>ik .
Jeʼ , xatutzukuj .	Jeʼ , x>at>u>tzuku>j .
Xkaʼy chirij , xkaʼy chuwach , ma kʼo ta chi jun ksilobʼik , xoqʼik xuxeʼj ribʼ xchʼopinik xtzalij loq xuriq ta chik ri ubʼe .	X>kaʼy chi>r>ij , x>kaʼy ch>u>wach , ma kʼo ta chi jun k>silobʼ>ik , x>oqʼ>ik x>u>xeʼ>j r>ibʼ x>chʼopin>ik x>tzalij loq x>u>riq ta chik ri u>bʼe .
Na kojpe taj .	Na k>oj>pe taj .
Pa Nawal jaʼ xinalexik .	Pa Nawal jaʼ x>in>alex>ik .
Xsachon ri nuchak chwe .	X>sachon ri nu>chak ch>w>e .
Jas ubʼiʼ le atinamit ?	Jas u>bʼiʼ le a>tinamit ?
Are ri achi xinchʼayowik .	Are ri achi x>in>chʼay>ow>ik .
Kinkiʼkotik in kʼo iwukʼ .	K>in>kiʼkot>ik in kʼo iw>ukʼ .
Xpe ri imul xutzeʼj uwach ri kok , xkiyuk bʼa kʼibʼ le kebʼ awajibʼ rech kel che anim .	X>pe ri imul x>u>tzeʼj u>wach ri kok , x>ki>yuk bʼa kʼ>ibʼ le kebʼ awaj>ibʼ r>ech k>el ch>e anim .
Petinaq ri saqil .	Petinaq ri saqil .
Noʼjim ta bʼa kakikʼoxomaj .	Noʼjim ta bʼa ka>ki>kʼoxoma>j .
Ri sameʼt kbʼan che le salwaʼt .	Ri sameʼt k>bʼan ch>e le salwaʼt .
Xtij ri ochʼ rumal ri chʼok .	X>tij ri ochʼ r>umal ri chʼok .
Kenchʼabʼej le akʼalabʼ .	K>e>n>chʼabʼe>j le akʼal>abʼ .
Sibʼalaj xinkʼaʼnarik .	Sibʼalaj x>in>kʼaʼnar>ik .
Le yabʼil ( COVID-19 ) loqʼ kqʼaxix pa ri qʼaqʼ xuqujeʼ chʼaqal taq tinmit .	Le yabʼil ( COVID-19 ) loqʼ k>qʼaxi>x pa ri qʼaqʼ xuqujeʼ chʼaqal taq tinmit .
Xinloqʼ jun chʼichʼ , qajinaq uwach .	X>in>loqʼ jun chʼichʼ , qajinaq u>wach .
Xinwilo chi xatwaʼik .	X>inw>il>o chi x>at>waʼ>ik .
Katpe je waʼ .	K>at>pe je waʼ .
Kʼax le kibʼe le winaq .	Kʼax le ki>bʼe le winaq .
Na xinta taj we are ri akʼal kixtzuquwik .	Na x>in>ta taj we are ri akʼal k>ix>tzuq>uw>ik .
We ta je laʼ kabʼan pa le tinamit .	We ta je laʼ ka>bʼan pa le tinamit .
We katij tzam man katuchajij ta che le COVID-19 xuqujeʼ xibʼabʼal chawe .	We ka>tij tzam man k>at>u>chaji>j ta ch>e le COVID-19 xuqujeʼ xibʼabʼal ch>aw>e .
Xuchap ukunaxik .	X>u>chap u>kuna>x>ik .
Xkʼotochin chi kiwach chi xojalwoʼqa kukʼ .	X>kʼotochin chi ki>wach chi x>oj>al>woʼ>qa k>ukʼ .
Xawil le ixoq taq xukoj ulo le wa .	X>aw>il le ixoq taq x>u>koj ulo le wa .
Jawi kawaj katwaʼ wi .	Jawi k>aw>aj k>at>waʼ wi .
Kinuloqʼoj le nutat .	K>in>u>loqʼo>j le nu>tat .
Kinuloqʼoj le nutat .	K>in>u>loqʼo>j le nu>tat .
Xqaj chi rij ri achi ri kaqulja .	X>qaj chi r>ij ri achi ri kaqulja .
Ri Max Suʼy naj kel wi .	Ri Max Suʼy naj k>el wi .
At xinxibʼin pa bʼe .	At x>in>xibʼi>n pa bʼe .
Le woʼch kʼo chunaqaj le nimatijobʼal .	Le w>oʼch kʼo ch>u>naqaj le nimatijobʼal .
Loqʼ katkuntaj che le yabʼil ( COVID-19 ) .	Loqʼ k>at>kun>taj ch>e le yabʼil ( COVID-19 ) .
Pa ri komon rech San Vicente Buenabaj .	Pa ri komon rech San Vicente Buenabaj .
Le jobʼ chij sibʼalaj xewaʼik cho le uwosaq , xbʼantajik chi xkikʼyaq kan le kimes pa taq le cheʼ pa le uwosaq .	Le jobʼ chij sibʼalaj x>e>waʼ>ik ch>o le uwosaq , x>bʼan>taj>ik chi x>ki>kʼyaq kan le ki>mes pa taq le cheʼ pa le uwosaq .
Kʼo jumul kebʼ alabʼom , ekʼo jobʼ kichij , xkichomaj kebeʼ pa yuqʼ .	Kʼo jumul kebʼ alabʼom , e>kʼo jobʼ ki>chij , x>ki>choma>j k>e>beʼ pa yuqʼ .
Ekʼo kajibʼ ral ri imul , jun saq , jun qʼan , jun qʼeq , jun qʼeqoj , sibʼalaj ketzʼanik , kechʼopinik ri alaj taq imul .	E>kʼo kajibʼ r>al ri imul , jun saq , jun qʼan , jun qʼeq , jun qʼeqoj , sibʼalaj k>etzʼan>ik , k>e>chʼopin>ik ri alaj taq imul .
Xmuqtaj ri patzʼan .	X>muqtaj ri patzʼan .
Ri chʼima man kkʼiy taj pa taqʼaj .	Ri chʼima man k>kʼiy taj pa taqʼaj .
Qʼeq chiʼl saq kkaʼy ri achim .	Qʼeq chiʼl saq k>kaʼy ri a>chim .
Ma ta xinyaj le ali .	Ma ta x>in>ya>j le ali .
Nitzʼ awa katijo .	Nitzʼ a>wa ka>tij>o .
Xril le bʼa le ala .	X>r>il le bʼa le ala .
Na nutom ta le tzij …	Na nu>tom ta le tzij …
Are le ukemik pas xretaʼmaj .	Are le u>kem>ik pas x>r>etaʼma>j .
E ... in kawaj katzjoj bʼi la chwe .	E ... in k>awaj k>a>tzjoj bʼi la ch>w>e .
Are ta bʼa ri qaqajaw kixtewechiʼnik .	Are ta bʼa ri qa>qajaw k>ix>tewechiʼ>n>ik .
Xojkitʼuyubʼaʼ rech kixqatatabʼej .	X>oj>ki>tʼuy>ubʼaʼ r>ech k>ix>qa>tatabʼe>j .
Utz le xubʼij le achi .	Utz le x>u>bʼi>j le achi .
Uwaq : are taq kchaqʼajik taqal chik che utijik .	Uwaq : are taq k>chaqʼaj>ik taqal chik ch>e u>tij>ik .
Ri wixnam chʼajchʼoj ri rachoch .	Ri w>ixnam chʼajchʼoj ri r>achoch .
Chanim kebʼ noʼj pa ri mayabʼ ajilabʼal qʼij .	Chanim kebʼ noʼj pa ri mayabʼ ajilabʼal qʼij .
Chitatabʼej jas ri kimbʼij .	Ch>i>tatabʼe>j jas ri k>im>bʼi>j .
chiʼ kʼo wi ri nimalaj etaʼmanel .	chiʼ kʼo wi ri nim>alaj etaʼmanel .
Xinkos rumal .	X>in>kos r>umal .
We xkam ri winaq , ri pwaq rech tojbʼal makaj kyaʼ chi kech ri ralaxik .	We x>kam ri winaq , ri pwaq r>ech tojbʼal makaj k>yaʼ chi k>ech ri r>alaxik .
Xaq katchʼoknaj iwir .	Xaq k>at>chʼoknaj iwir .
Le wuj ri xasipaj chwe sibʼalaj utz kinwilo .	Le wuj ri x>a>sipa>j ch>w>e sibʼalaj utz k>inw>il>o .
Xkʼulmataj jumul , xubʼan jun nimalaj jabʼ , man xbʼeyetaj ta na xukʼis le uyuqʼ chike .	X>kʼulma>taj jumul , x>u>bʼan jun nim>alaj jabʼ , man x>bʼeyetaj ta na x>u>kʼis le u>yuqʼ chi>k>e .
Ri nuchaqʼ kʼo pa uroʼ qʼatoj tijonik pa ri tijobʼal .	Ri nu>chaqʼ kʼo pa uroʼ qʼatoj tijonik pa ri tijobʼal .
Kʼisbʼal kinbʼek .	Kʼisbʼal k>in>bʼe>k .
Nim ri upwiʼri a Kulax .	Nim ri u>pwiʼri a Kulax .
Xintij le subʼ .	X>in>tij le subʼ .
Ri a Teʼk jun sanasik achi .	Ri a Teʼk jun sanasik achi .
Katzukun la chwe .	Ka>tzuku>n la ch>w>e .
Xinkos rumal nuchak .	X>in>kos r>umal nu>chak .
Kwaj miqʼin taq lej .	K>w>aj miqʼin taq lej .
Xepe le winaq xolkikʼamaʼ .	X>e>pe le winaq x>ol>ki>kʼam>aʼ .
Jampa kojbʼe pa le tyox ?	Jampa k>oj>bʼe pa le tyox ?
Kamik kʼakʼ ikʼ .	Kamik kʼakʼ ikʼ .
Kayaʼtajik rukʼ utiʼonem jun ri uriqom le yabʼil amolo tsetsé xuqujeʼ are kayaʼtaj pa taq ri juyubʼ .	Ka>yaʼ>taj>ik r>ukʼ u>tiʼonem jun ri u>riq>om le yabʼil amolo tsetsé xuqujeʼ are ka>yaʼ>taj pa taq ri juyubʼ .
Xekos le ixoqibʼ pa le bʼe .	X>e>kos le ixoq>ibʼ pa le bʼe .
Paqal rajil ri kʼoxobʼ .	Paqal rajil ri kʼoxobʼ .
Kexojow ri ajxojolobʼ .	K>e>xojow ri ajxojolobʼ .
Ri okibʼal kʼo chi uwach ri saq ja .	Ri okibʼal kʼo chi u>wach ri saq ja .
Kamik xujbʼe che utikik taq cheʼ pa ri juyubʼ .	Kamik x>uj>bʼe ch>e u>tik>ik taq cheʼ pa ri juyubʼ .
Ma Numak xyawajik .	Ma Nu>mak x>yawaj>ik .
Oxibʼ ri raqan ja kʼolik .	Oxibʼ ri r>aqan ja kʼol>ik .
Rajawaxik jun chʼichʼ chwe .	Rajawaxik jun chʼichʼ ch>w>e .
Ri in , xintaq bʼi ri Tikiko pa ri Efeso .	Ri in , x>in>taq bʼi ri Tikiko pa ri Efeso .
Utz we kutij saqmoʼl ri akʼalabʼ .	Utz we k>u>tij saqmoʼl ri akʼal>abʼ .
chi upam ri pek kʼo jaʼ .	chi u>pam ri pek kʼo jaʼ .
Xuqʼiʼo are le ukʼulel xyaʼow uwa .	X>u>qʼiʼ>o are le u>kʼulel x>yaʼ>ow u>wa .
La katbʼe pa le tinamit ?	La k>at>bʼe pa le tinamit ?
La katbʼe pa le tinamit ?	La k>at>bʼe pa le tinamit ?
Ri kʼamal bʼe xubʼij chike , chimaja ri anim .	Ri kʼamal bʼe x>u>bʼij chi>k>e , ch>i>maja ri anim .
Qʼiptajinaq ri raqan ri tem .	Qʼiptajinaq ri r>aqan ri tem .
Tajin kinajilan chiʼ xulik .	Tajin k>in>ajilan chiʼ x>ul>ik .
Jun aqʼabʼil kʼo ri ali Naʼ chi uwach ri rachoch .	Jun aqʼabʼil kʼo ri ali Naʼ chi u>wach ri r>achoch .
Ronojel aqʼabʼ kinyitzʼ ri wakax .	R>onojel aqʼabʼ k>in>yitzʼ ri wakax .
Ri nuxibʼal kel pa qajbʼal qʼij .	Ri nu>xibʼal k>el pa qajbʼal qʼij .
Pa le jun wokaj ubʼiʼ Chi Masat kape wi le achi .	Pa le jun wokaj u>bʼiʼ Chi Masat ka>pe wi le achi .
Ri yabʼ ixoq sibʼalaj qʼaqʼ kʼo chi rij .	Ri yabʼ ixoq sibʼalaj qʼaqʼ kʼo chi r>ij .
In xintoʼw la .	In x>in>toʼ>w la .
Chech punción lumbar amaqʼel rajawaxik chech rilik le ukʼexbʼem wi le nabʼe rukʼ le ukabʼ ukʼutunem le yabʼilal .	Ch>ech punción lumbar amaqʼel rajawaxik ch>ech rilik le u>kʼexbʼem wi le nabʼe r>ukʼ le ukabʼ u>kʼutunem le yabʼilal .
Xkanaj kanoq chi uxeʼ ri jabʼ ri chʼaʼn .	X>kanaj kan>oq chi u>xeʼ ri jabʼ ri chʼaʼn .
Jas kawaj kintijo ?	Jas k>aw>aj k>in>tij>o ?
Ronojel qʼij kinchʼaj le nuware .	R>onojel qʼij k>in>chʼaj le nu>ware .
Ri nim taq chuchqajawibʼ , xoqujʼe kkaj kkikamisaj ri Lasaro .	Ri nim taq chuchqajaw>ibʼ , xoqujʼe k>k>aj k>ki>kamisaj ri Lasaro .
Riʼ ri kebʼ nimaq taq ral ri ixoq riʼ .	Riʼ ri kebʼ nim>aq taq r>al ri ixoq riʼ .
kʼo ri kiʼkotemal awukʼ .	kʼo ri kiʼkotemal aw>ukʼ .
Ko kaxim ri chij xa je laʼ man kanimaj ta bʼik .	Ko ka>xim ri chij xa je laʼ man k>animaj ta bʼi>k .
Xojkichapo .	X>oj>ki>chap>o .
Jeʼ chweʼq kinbʼek jelaʼ .	Jeʼ chweʼq k>in>bʼe>k jelaʼ .
¿ Kʼo ri muqʼe chi awech ?	¿ Kʼo ri muqʼe chi aw>ech ?
Ri ajtij Lol xuta chike jawi xkichap wi ri alaj imul .	Ri aj>tij Lol x>u>ta chi>k>e jawi x>ki>chap wi ri alaj imul .
Kʼo awetaʼmabʼal .	Kʼo aw>etaʼmabʼal .
Are xeʼopan chi uchiʼ ri juyubʼ , xkilo chi man qas ta kʼo qʼayes .	Are x>eʼ>opan chi u>chiʼ ri juyubʼ , x>ki>lo chi man qas ta kʼo qʼayes .
Wech ri suʼt saq uwach kʼo chi upam ri ja .	W>ech ri suʼt saq u>wach kʼo chi u>pam ri ja .
Ri watiʼt ubʼiʼ Roʼs .	Ri w>atiʼt u>bʼiʼ Roʼs .
Ri nuxajabʼ kacharanik .	Ri nu>xajabʼ ka>charan>ik .
Xpaqiʼ rajil ronojel ri jastaq .	X>paqiʼ rajil r>onojel ri jastaq .
Chikop waʼ .	Chikop waʼ .
Nim nukʼas .	Nim nu>kʼas .
La kamik kakʼam luʼbʼik ?	La kamik ka>kʼam luʼ>bʼi>k ?
Upimal le lej .	U>pimal le lej .
Kʼo nuwa chiʼ .	Kʼo nu>wa chiʼ .
Xa rumal sibʼalaj rajawaxik le loqʼalaj jaʼ , le winaq xkibʼij : che we ikʼ riʼ qonojel kujbʼe che utikik taq cheʼ .	Xa r>umal sibʼalaj rajawaxik le loqʼ>alaj jaʼ , le winaq x>ki>bʼij : ch>e we ikʼ riʼ q>onojel k>uj>bʼe ch>e u>tik>ik taq cheʼ .
Xsachan chwe .	X>sach>an ch>w>e .
Xsachan chwe .	X>sach>an ch>w>e .
Na jupulik ta xeqaj laʼkʼalabʼ .	Na jupulik ta x>e>qaj l>aʼkʼal>abʼ .
Xeʼnwila le etzʼanem oxjir .	X>eʼ>nw>il>a le etzʼanem oxjir .
Chixqʼatan loq je waʼ , rumal che tolonik .	Ch>ix>qʼatan loq je waʼ , r>umal ch>e tolonik .
Nojinaq ri kej .	Nojinaq ri kej .
La xebʼe kʼu la xeʼkijaqa kʼu le uchiʼ ja ?	La x>e>bʼe kʼu la x>eʼ>ki>jaq>a kʼu le u>chiʼ ja ?
Na kaqakʼam tuʼbʼi kamik .	Na ka>qa>kʼam tuʼ>bʼi kamik .
E kʼo kʼi cheʼ , chi uwach ri juyubʼ .	E kʼo kʼi cheʼ , chi u>wach ri juyubʼ .
Qastzij xcha ri kok , in nojim kinbʼinik .	Qastzij x>cha ri kok , in nojim k>in>bʼin>ik .
E kʼo lajuj wakʼ .	E kʼo lajuj w>akʼ .
Kape le a Wel pa Nawaljaʼ .	Ka>pe le a Wel pa Nawaljaʼ .
We chojbʼe pa le nimaqʼij , keqil le ajxojolobʼ .	We ch>oj>bʼe pa le nimaqʼij , k>e>q>il le ajxojolobʼ .
Xa rajawaxik kqatoʼ qibʼ pa qakʼaslemal .	Xa rajawaxik k>qa>toʼ q>ibʼ pa qa>kʼaslemal .
Kʼax wij rumal in pachalik .	Kʼax w>ij r>umal in pachalik .
Ri ukabʼ ubʼiʼ ri numam are Yay .	Ri ukabʼ u>bʼiʼ ri nu>mam are Yay .
Qʼalaj chik .	Qʼalaj chik .
Kinbʼison che le wal .	K>in>bʼiso>n ch>e le w>al .
Man katkowin taj katchakunik , we man kʼo ta ri ajilabʼal .	Man k>at>kowin taj k>at>chakun>ik , we man kʼo ta ri ajilabʼal .
Xutijo .	X>u>tij>o .
E jobʼ ri tijoxelabʼ e kʼo pa ri tijobʼal .	E jobʼ ri tijoxel>abʼ e kʼo pa ri tijobʼal .
La xaloqʼ jun alej ?	La x>a>loqʼ jun a>lej ?
Are le Tuʼr le loqʼomanel .	Are le Tuʼr le loqʼomanel .
Na wetaʼm taj .	Na w>etaʼm taj .
Xojpixabʼanik .	X>oj>pixabʼa>n>ik .
Xsachan le tzij chwe .	X>sach>an le tzij ch>w>e .
Mem ri achi .	Mem ri achi .
Kkʼojiʼ bʼaʼ ri usipanik ri ajawxel Jesus Kristo rukʼ ri awuxlabʼal !	K>kʼojiʼ bʼaʼ ri u>sipanik ri ajawxel Jesus Kristo r>ukʼ ri aw>uxlabʼal !
Xuloqʼ ri wuj ri ali .	X>ul>oqʼ ri wuj ri ali .
Waʼim xuchapo .	Waʼ>im x>u>chap>o .
Kintzukun che la .	K>in>tzuku>n ch>e la .
Kawaj chi katʼek .	Ka>w>aj chi k>at>ʼek .
Ri abʼaj yatzalik .	Ri abʼaj yatzalik .
Ma ta xabʼinsaj le chʼichʼ .	Ma ta x>a>bʼinsa>j le chʼichʼ .
Xinkosik .	X>in>kos>ik .
Xinkosik .	X>in>kos>ik .
Xojkiʼkotik aretaq xatulik .	X>oj>kiʼkot>ik aretaq x>at>ul>ik .
Le e kʼaʼna taq tzʼiʼ .	Le e kʼaʼn>a taq tzʼiʼ .
Xinloqʼ ulo jun wuj rech kasikʼij uwach .	X>in>loqʼ ulo jun wuj r>ech k>a>sikʼi>j u>wach .
Na xwaj ta chik xinbʼij .	Na x>w>aj ta chik x>in>bʼij .
Jas uwach le rikil kakitij le aj Nawaljaʼ ?	Jas u>wach le rikil ka>ki>tij le aj Nawaljaʼ ?
Waral man kʼo taj Ajawal .	Waral man kʼo taj Ajawal .
Jas karaj kaʼan chutzakik le tiʼij .	Jas ka>r>aj k>a>ʼan ch>u>tzak>ik le tiʼij .
Kwaj na katʼe taj .	K>w>aj na k>at>ʼe taj .
Na xatutzukuj taj .	Na x>at>u>tzuku>j taj .
Areʼ ukakʼal ujunabʼ ri tijobʼal qukʼ .	Areʼ ukakʼal u>junabʼ ri tijobʼal q>ukʼ .
Kinjopij ri ijaʼ rech triko .	K>in>jopi>j ri ijaʼ r>ech triko .
Xinpetik , tat .	X>in>pet>ik , tat .
La kʼo tzij na kikʼoxomaj taj ?	La kʼo tzij na k>i>kʼoxoma>j taj ?
Mawilo .	M>aw>il>o .
Xinloqʼ jun ilbʼal wibʼ .	X>in>loqʼ jun ilbʼal w>ibʼ .
Kkowin ri kunanel che kunanik .	K>kowin ri kunanel ch>e kunanik .
Paqal rajil ri taq etzʼabʼaʼl .	Paqal rajil ri taq etzʼabʼaʼl .
Kiʼ ri ukabʼ ri aqaj .	Kiʼ ri ukabʼ ri aqaj .
Tzalatzik xkanaj kanoq ri qachak .	Tzalatzik x>kanaj kan>oq ri qa>chak .
Kamik kʼo chi ri jas taq awe .	Kamik kʼo chi ri jas taq aw>e .
We ta ne in xinbʼanowik , are le a Teʼk xbʼanowik .	We ta ne in x>in>bʼan>ow>ik , are le a Teʼk x>bʼan>ow>ik .
Jas rukʼ xkitij wi le kirikil ?	Jas r>ukʼ x>ki>tij wi le ki>rikil ?
Tza ri choʼm .	Tza ri choʼm .
Na xwaj taj xinbʼij .	Na x>w>aj taj x>in>bʼij .
Utz we kwar alaq .	Utz we k>war alaq .
Xuta jachin kaʼek .	X>u>ta jachin k>a>ʼe>k .
Kkiʼkot ri nukʼulaj .	K>kiʼkot ri nu>kʼulaj .
Xinwilo chi xwaʼ ri ala .	X>inw>il>o chi x>waʼ ri ala .
Utzalaj ajchak , ri Wel .	Utz>alaj ajchak , ri Wel .
Jas xutij le ala xawilo ?	Jas x>u>tij le ala x>aw>il>o ?
Kikikʼam bʼik nimaʼq taq keqaʼn e chiʼ kebʼek .	Ki>ki>kʼam bʼi>k nim>aʼq taq k>eqaʼn e chiʼ k>e>bʼe>k .
Na xinta taj we na kixtzuq taj .	Na x>in>ta taj we na k>ix>tzuq taj .
Xinchakun rukʼ ri numam .	X>in>chakun r>ukʼ ri nu>mam .
Man xuriq taj urikil xaq jeri xkam che wiʼjal .	Man x>u>riq taj u>rikil xaq jeri x>kam ch>e wiʼjal .
Xjiqʼ pa ri polow .	X>jiqʼ pa ri polow .
Ajqʼojom , ri nutat .	Ajqʼojom , ri nu>tat .
Uj kʼo pa qʼequʼm .	Uj kʼo pa qʼequʼm .
Chitatabʼej jas we kimbʼij .	Ch>i>tatabʼe>j jas we k>im>bʼi>j .
Katakʼmaʼy ri wakʼ .	Ka>takʼmaʼy ri w>akʼ .
Xukʼutu rech kaqilo .	X>u>kʼut>u r>ech ka>q>il>o .
Xeʼok ri pokʼ pa ri umexa ri Poʼx .	X>eʼ>ok ri pokʼ pa ri u>mexa ri Poʼx .
Ri watiʼt kʼo rulew je laʼ pa Taqʼaj .	Ri w>atiʼt kʼo r>ulew je laʼ pa Taqʼaj .
Are nim le atzʼiʼ chuwach le nutzʼiʼ .	Are nim le a>tzʼiʼ ch>u>wach le nu>tzʼiʼ .
Tajin kaqʼanik pa uwiʼ ri ja .	Tajin ka>qʼa>n>ik pa u>wiʼ ri ja .
Ri tzʼiʼ xuloqʼ ri numiʼal pa kʼayibʼal xkamik .	Ri tzʼiʼ x>ul>oqʼ ri nu>miʼal pa kʼayibʼal x>kamik .
Jun qʼij kanoq pa komon Xechpup uqʼabʼ tinamit Xoʼl Abʼaj .	Jun qʼij kan>oq pa komon Xechpup u>qʼabʼ tinamit Xoʼl Abʼaj .
Xatkanaj kanoq kukʼ ri anan atat .	X>at>kanaj kan>oq k>ukʼ ri a>nan a>tat .
Putzuk ri uwiʼ ri a Kel .	Putzuk ri u>wiʼ ri a Kel .
La kakowin alaq kintoʼ alaq ?	La ka>kowin alaq k>in>toʼ alaq ?
E kʼo ri eloqʼomanel .	E kʼo ri e>loqʼomanel .
Xinsikʼij la .	X>in>sikʼi>j la .
Uj kʼo chi uxeʼ taq ri cheʼ .	Uj kʼo chi u>xeʼ taq ri cheʼ .
Pa jun nim kʼacheʼlaj , kʼo jun kʼwaʼ sibʼalaj saqloloj , nim uwach .	Pa jun nim kʼacheʼlaj , kʼo jun kʼwaʼ sibʼalaj saqloloj , nim u>wach .
Ri a Tiʼx xeresaj ri awajibʼ , xbʼe pa yuqʼ .	Ri a Tiʼx x>e>resaj ri awaj>ibʼ , x>bʼe pa yuqʼ .
Kubʼij chech naʼl kabʼan che ri a tzʼibʼ .	K>u>bʼij ch>ech naʼl ka>bʼan ch>e ri a tzʼibʼ .
Pa oxqʼij ri Saʼn kbʼe na rukʼ ri ajkun .	Pa oxqʼij ri Saʼn k>bʼe na r>ukʼ ri ajkun .
Tajin katix ri jaʼ .	Tajin ka>tix ri jaʼ .
Yamanik ri nuwixikin .	Yamanik ri nu>wixikin .
Kbʼe kukʼ ri eʼareʼ e ktzalij pa ri Nasaret e keʼunimaj .	K>bʼe k>ukʼ ri eʼareʼ e k>tzalij pa ri Nasaret e k>eʼ>u>nimaj .
Xkʼam ri nuwuj .	X>kʼam ri nu>wuj .
In xatinchʼayo .	In x>at>in>chʼay>o .
Xinjokʼ ri triko che ubʼanik lej .	X>in>jokʼ ri triko ch>e u>bʼan>ik lej .
E kʼi ri kʼat kʼolik .	E kʼi ri kʼat kʼol>ik .
Wemna chaloqʼ axiyal , na kimbʼe ta awukʼ .	We>mna ch>a>loqʼ axiyal , na k>im>bʼe ta aw>ukʼ .
Soposik le reqaʼn .	Soposik le r>eqaʼn .
Sibʼalaj itzel ubʼantajik ri chʼilakan .	Sibʼalaj itzel u>bʼantajik ri chʼilakan .
Ri pwaq rech we qʼataj riʼ kesax chech ri tojbʼal kʼayinem .	Ri pwaq r>ech we qʼataj riʼ k>e>sa>x ch>ech ri tojbʼal kʼayinem .
Xtzijon ri nutat wukʼ .	X>tzijon ri nu>tat w>ukʼ .
Xinkikot awumal .	X>in>kikot aw>umal .
Kqʼaqʼan ri waqan .	K>qʼaqʼan ri w>aqan .
Kaloqʼon le nutat chwe .	Ka>loqʼo>n le nu>tat ch>w>e .
Kwaj katij jubʼaʼ wa .	K>w>aj ka>tij jubʼaʼ wa .
E kʼi ri ixoqibʼ e kʼo pa ri malkaʼnil .	E kʼi ri ixoq>ibʼ e kʼo pa ri malkaʼnil .
Xixusikʼij ulo chi iqilik .	X>ix>u>sikʼi>j ulo chi i>q>il>ik .
Ketikon ri achijabʼ .	K>e>tiko>n ri achij>abʼ .
Amaʼ ri nutzʼiʼ .	Amaʼ ri nu>tzʼiʼ .
Kamik man kinbʼe ta chi uwach ri ja .	Kamik man k>in>bʼe ta chi u>wach ri ja .
Xintik oxlajkʼal ichaj .	X>in>tik oxlajkʼal ichaj .
Kamik man kʼo taj nuchʼakoj .	Kamik man kʼo taj nu>chʼakoj .
Man are ta ri a Xwan xelik .	Man are ta ri a Xwan x>el>ik .
Tajin katkʼiyik .	Tajin k>at>kʼiy>ik .
Ajwaral ri tataʼ Kux .	Ajwaral ri tataʼ Kux .
Kajuluw ri aqʼaʼl chi uxeʼ ri tʼuʼy .	Ka>juluw ri aqʼaʼl chi u>xeʼ ri tʼuʼy .
Na kabʼantaj ta wumal .	Na ka>bʼan>taj ta w>umal .
Na kabʼantaj ta wumal .	Na ka>bʼan>taj ta w>umal .
Xinloqʼ kʼi .	X>in>loqʼ kʼi .
Jas rukʼ xawil wi chi xkiqupij wi le tiʼj .	Jas r>ukʼ x>aw>il wi chi x>ki>qupi>j wi le tiʼj .
Kʼo kebʼ ubʼantajik le kubʼan kʼax chi kech le e winaq , Trypanosoma brucei gambiense ( T.b.g ) chiʼl Trypanosoma brucei rhodesiense ( T.b.r ) .	Kʼo kebʼ u>bʼantajik le k>u>bʼan kʼax chi k>ech le e winaq , Trypanosoma brucei gambiense ( T.b.g ) chiʼl Trypanosoma brucei rhodesiense ( T.b.r ) .
Sibʼalaj jeʼl xkilo xekitzoqopij ri kichij chilaʼ .	Sibʼalaj jeʼl x>ki>lo x>e>ki>tzoqopi>j ri ki>chij chilaʼ .
Saqpor kkay ri kipoʼt ri nan .	Saqpor k>kay ri ki>poʼt ri nan .
Chinatisaj ri rixoqil ri Lot .	Chi>natisa>j ri r>ixoqil ri Lot .
Na qʼalaj taj we kaʼek .	Na qʼalaj taj we k>a>ʼek .
Sibʼalaj jeʼl ktijow ri axux rukʼ ri rikil .	Sibʼalaj jeʼl k>tijow ri axux r>ukʼ ri rikil .
We kʼo arajil chakʼama loq .	We kʼo a>rajil ch>a>kʼam>a loq .
Lal kʼamal bʼe .	Lal kʼamal bʼe .
Man are ta xril .	Man are ta x>r>il .
Le ukemik le pas utz ( chawe ) .	Le u>kem>ik le pas utz ( ch>aw>e ) .
Uj mayabʼ .	Uj mayabʼ .
Na xsachon ta chke xeatinik .	Na x>sachon ta ch>k>e x>e>atin>ik .
In kʼo che ri tobʼanel .	In kʼo ch>e ri tobʼanel .
Ri ukʼyabʼal naj upam .	Ri ukʼyabʼal naj u>pam .
La waral kʼu xixwaʼ wi ?	La waral kʼu x>ix>waʼ wi ?
Kinqumuj ri nujochʼ .	K>in>qumu>j ri nu>jochʼ .
Xkʼotochin chi kiwach chi kojalwoʼqa kukʼ .	X>kʼotochin chi ki>wach chi k>oj>al>woʼ>qa k>ukʼ .
Le tzʼiʼ man xkitij taj .	Le tzʼiʼ man x>ki>tij taj .
Ri uxaq ri abʼix are uwa ri kej .	Ri u>xaq ri abʼix are u>wa ri kej .
Xax rij ri saqmoʼl .	Xax r>ij ri saqmoʼl .
Xubʼij loq chi we rukʼ rutzil animaʼ .	X>u>bʼij loq chi w>e r>ukʼ r>utzil animaʼ .
Qʼayinaq ri ankaneʼy .	Qʼayinaq ri ankaneʼy .
Le ukunaxik le ukabʼ ukʼutunik are rukʼ eflornitina on utunibʼaxik le nifurtimox chiʼl eflornitina chech T.b.g .	Le u>kunaxik le ukabʼ u>kʼutunik are r>ukʼ eflornitina on u>tunibʼaxik le nifurtimox chiʼl eflornitina ch>ech T.b.g .
Xeʼul le ala chiʼl le ali .	X>eʼ>ul le ala chiʼl le ali .
Xkilo chi kinkʼoxomaj .	X>k>il>o chi k>in>kʼoxoma>j .
Xkilo chi kinkʼoxomaj .	X>k>il>o chi k>in>kʼoxoma>j .
Le ala xokik .	Le ala x>ok>ik .
Ri a Teʼk xutaʼ chech ri nan Toʼn : - nan jas cheʼ chi man kaj ta la qakʼatisaj ri joʼq .	Ri a Teʼk x>u>taʼ ch>ech ri nan Toʼn : - nan jas cheʼ chi man k>aj ta la qa>kʼatisa>j ri joʼq .
We kinkos rumal , kinwarik .	We k>in>kos r>umal , k>in>war>ik .
Kʼax rilik le akʼal chawe .	Kʼax r>il>ik le akʼal ch>aw>e .
Xpaqabʼisax rajil ronojel ri kem .	X>paqabʼisa>x rajil r>onojel ri kem .
Kʼatekʼuriʼ , pa taq we qʼij riʼ , ri Jesus kpe uloq chi pa ri Nasaret rech ri Galileʼa , kʼatekʼuriʼ ri Xwan kubʼan uqasnaʼ pa ri Jordan .	Kʼatekʼuriʼ , pa taq we qʼij riʼ , ri Jesus k>pe uloq chi pa ri Nasaret r>ech ri Galileʼa , kʼatekʼuriʼ ri Xwan k>u>bʼan u>qasnaʼ pa ri Jordan .
Ix ixoqibʼ .	Ix ixoq>ibʼ .
Ri chʼima kʼa tʼon na .	Ri chʼima kʼa tʼon na .
Ukiʼil le taraʼs .	U>kiʼil le taraʼs .
Ri ulew man qech taj , kech ri qatiʼt qamam .	Ri ulew man q>ech taj , k>ech ri q>atiʼt qa>mam .
¿ Jumpaʼ ajilabʼal xabʼij chi wech ?	¿ Jumpaʼ ajilabʼal x>a>bʼij chi w>ech ?
Are waʼ nuwuj .	Are waʼ nu>wuj .
Kʼo nukʼulel .	Kʼo nu>kʼulel .
Puchʼ na ri aj .	Puchʼ na ri aj .
In bʼanal wa .	In bʼanal wa .
Kul le al Weʼl pa Austin chaqʼabʼ kamik .	K>ul le al Weʼl pa Austin chaqʼabʼ kamik .
Ri mesonel tajin kchakunik .	Ri mesonel tajin k>chakun>ik .
We taqanik riʼ kubʼij chi rajawaxik kyaʼ uqʼij ri winaq xuqujeʼ ktoʼ aninaqil .	We taqanik riʼ k>u>bʼij chi rajawaxik k>yaʼ u>qʼij ri winaq xuqujeʼ k>toʼ aninaqil .
Konojel xkichomaj rij , xkibʼij kʼut : areʼ utz ketik cheʼ .	K>onojel x>ki>choma>j r>ij , x>ki>bʼij kʼut : areʼ utz k>e>tik cheʼ .
Utz we achi we xinkunanik .	Utz we achi we x>in>kuna>n>ik .
Xkikunaj le ali ri ixoqibʼ .	X>ki>kuna>j le ali ri ixoq>ibʼ .
Tajin kejachʼanik .	Tajin k>e>jachʼ>an>ik .
Xaya jun awuj chwech .	X>a>ya jun a>wuj ch>w>ech .
Kiʼ ri kʼawex .	Kiʼ ri kʼawex .
Kbʼe pa ri Siriʼa e pa ri Silisiʼa , jawijeʼ kuya wi ri kichuqʼabʼ ri Komon Tyox .	K>bʼe pa ri Siriʼa e pa ri Silisiʼa , jawijeʼ k>u>ya wi ri ki>chuqʼabʼ ri Komon Tyox .
Xraj kaʼe le unan .	X>r>aj ka>ʼe le u>nan .
Pa waram xutaqchiʼj wi .	Pa war>am x>u>taqchiʼ>j wi .
Xatwaʼik xinwilo .	X>at>waʼ>ik x>inw>il>o .
Kʼo mes chi upam ri koxtar .	Kʼo mes chi u>pam ri koxtar .
We keqbʼan ri qʼuch utz kujelik .	We k>e>q>bʼan ri qʼuch utz k>uj>el>ik .
Kachuwir ri tiʼj .	Ka>chuwir ri tiʼj .
Xukʼasuj le ral : - Tiʼx , Tiʼx , chatwalijoq , xutzir ri awaʼ xcha che .	X>u>kʼasu>j le r>al : - Tiʼx , Tiʼx , ch>at>walij>oq , x>utzir ri a>waʼ x>cha ch>e .
Ma ta bʼa chiriq kʼax pa le bʼe .	Ma ta bʼa ch>i>riq kʼax pa le bʼe .
Kʼo pus che ri wa .	Kʼo pus ch>e ri wa .
Qʼan ri nukaxa .	Qʼan ri nu>kaxa .
Le tzʼiʼ xekosik .	Le tzʼiʼ x>e>kos>ik .
Wetaʼam chi pulew xwar wi .	W>etaʼ>am chi p>ulew x>war wi .
Na kimbʼin taj .	Na k>im>bʼin taj .
Utz ri nutzʼiʼ ri xisipaj chwe .	Utz ri nu>tzʼiʼ ri x>i>sipa>j ch>w>e .
Xubʼij chwe jawi kʼow kanoq .	X>u>bʼij ch>w>e jawi kʼo>w kan>oq .
Kʼatekʼut , xinbʼe pa ri Siriʼa e pa ri Silisiʼa ;	Kʼatekʼut , x>in>bʼe pa ri Siriʼa e pa ri Silisiʼa ;
Rilik .	R>il>ik .
La xtzalij la iwir ?	La x>tzalij la iwir ?
Ri Oxlajuj Kej , nimaqʼij pa ri nutinamit .	Ri Oxlajuj Kej , nimaqʼij pa ri nu>tinamit .
We kʼu xokik , we kʼna xok ta pa rsin kijolom .	We kʼu x>ok>ik , we kʼ>na x>ok ta pa r>sin ki>jolom .
Sibʼalaj chʼeʼr ri neʼ .	Sibʼalaj chʼeʼr ri neʼ .
Sibʼalaj ko , ri kʼakʼ chʼat .	Sibʼalaj ko , ri kʼakʼ chʼat .
Tajin kepixbʼax ri akʼalabʼ .	Tajin k>e>pixbʼa>x ri akʼal>abʼ .
Chitatabʼej jas le kimbʼij .	Ch>i>tatabʼe>j jas le k>im>bʼi>j .
Elaqʼanel rech chʼichʼ .	Elaqʼanel r>ech chʼichʼ .
Na iwir ta xril le kʼamol bʼe .	Na iwir ta x>r>il le kʼamol bʼe .
Oj ta bʼa chojchʼakanik .	Oj ta bʼa ch>oj>chʼak>an>ik .
Ri qʼaqʼ tajin kajuluwik .	Ri qʼaqʼ tajin ka>juluw>ik .
Qawuj .	Qa>wuj .
Ri tzʼalam tzʼibʼabʼal rax kkayik .	Ri tzʼalam tzʼibʼabʼal rax k>kay>ik .
Katchakunik rech keatzuq le awalkʼwal .	K>at>chakun>ik r>ech k>e>a>tzuq le awalkʼwal .
Jas xaqʼiʼo xatijo .	Jas x>a>qʼiʼ>o x>a>tij>o .
Are ta xraj le tzʼiʼ xok pa le jul , par na xkowin taj rumal sibʼalaj nim .	Are ta x>r>aj le tzʼiʼ x>ok pa le jul , par na x>kowin taj r>umal sibʼalaj nim .
Na kikityoxij ta chi kan kiwa .	Na ki>ki>tyoxi>j ta chi kan ki>wa .
Kinqʼojomaj le qʼojom .	K>in>qʼojoma>j le qʼojom .
Xnaʼtaj waʼim chwe .	X>naʼtaj waʼ>im ch>w>e .
Kintobʼan chech la .	K>in>tobʼa>n ch>ech la .
Xa jun ri mayabʼ noʼjibʼal .	Xa jun ri mayabʼ noʼjibʼal .
Nim ri aweqeleʼn xariqo .	Nim ri aw>eqeleʼn x>a>riq>o .
Chaqʼ chik ri wa .	Chaqʼ chik ri wa .
Kajilil ri bʼe .	Ka>jilil ri bʼe .
Noʼjim chak wumal .	Noʼjim chak w>umal .
Ri cheʼ tulul kʼo sibʼalaj uwach .	Ri cheʼ tulul kʼo sibʼalaj u>wach .
Are ta bʼa le qaqajaw chattoʼwik .	Are ta bʼa le qa>qajaw ch>at>toʼ>w>ik .
E kʼo sibʼalaj wulaʼ .	E kʼo sibʼalaj w>ulaʼ .
Yuʼl ubʼanom ri ukolobʼ ri kej .	Yuʼl u>bʼanom ri u>kolobʼ ri kej .
Ri ruq numiʼal xelaqʼaxik .	Ri r>uq nu>miʼal x>elaqʼa>x>ik .
Ri jaʼ kamiqʼik chi uwach ri qʼaqʼ .	Ri jaʼ ka>miqʼ>ik chi u>wach ri qʼaqʼ .
Ri wikan Chaliʼy kel pa juyubʼ Chwitziribʼal .	Ri w>ikan Chaliʼy k>el pa juyubʼ Chwitziribʼal .
Ri wachalal xuloqʼ ulew .	Ri w>achalal x>ul>oqʼ ulew .
¿ At kʼaslik ?	¿ At kʼaslik ?
Utz we nutzʼiʼ we xisipaj chwe .	Utz we nu>tzʼiʼ we x>i>sipa>j ch>w>e .
Kʼo kan wa rech kaqatijo .	Kʼo kan wa r>ech ka>qa>tij>o .
Xkotiʼ pa qʼayes xoqʼik .	X>kotiʼ pa qʼayes x>oqʼ>ik .
La utzakik kʼu subʼ tajin kuʼano ?	La u>tzak>ik kʼu subʼ tajin k>u>ʼan>o ?
Xepetik xolkilaʼ .	X>e>pet>ik x>ol>k>il>aʼ .
Xuqʼiʼo na xatatin taj .	X>u>qʼiʼ>o na x>at>atin taj .
Le tzʼibʼabʼal wech in .	Le tzʼibʼabʼal w>ech in .
Ri siʼ xkanaj chi uwach ri jabʼ .	Ri siʼ x>kanaj chi u>wach ri jabʼ .
Ri ali Wel xubʼan opanem .	Ri ali Wel x>u>bʼan opanem .
Naj kʼo wi ri juyubʼ .	Naj kʼo wi ri juyubʼ .
Utz laʼ le xubʼij le achi .	Utz laʼ le x>u>bʼi>j le achi .
Xloqʼ ulew iwech ix .	X>loqʼ ulew iw>ech ix .
Rajwaxik kqakoj kʼakʼ taq tzij .	Rajwaxik k>qa>koj kʼakʼ taq tzij .
Qonojel waʼ pa qʼabʼ la oj kʼo wi nudyos .	Q>onojel waʼ pa qʼabʼ la oj kʼo wi nu>dyos .
Noʼjimal ukemik le pas awumal .	Noʼjimal u>kem>ik le pas aw>umal .
Ma ta kʼo jun kakanaj kanoq , qonojel kojbʼek .	Ma ta kʼo jun ka>kanaj kan>oq , q>onojel k>oj>bʼe>k .
Chatbʼinoq .	Ch>at>bʼin>oq .
Chatbʼinoq .	Ch>at>bʼin>oq .
Ri Mariʼy naj xbʼe wi .	Ri Mariʼy naj x>bʼe wi .
Setesik ri ujolom ri ala .	Setesik ri u>jolom ri ala .
Kʼakʼ we atzʼyaqibʼal .	Kʼakʼ we atzʼyaqibʼal .
Tajin kel loq , ri qʼij .	Tajin k>el loq , ri qʼij .
Ri watiʼt Waʼn retaʼm ri ojer tzij .	Ri w>atiʼt Waʼn r>etaʼm ri ojer tzij .
Kʼakʼ ri ikʼ kamik .	Kʼakʼ ri ikʼ kamik .
Xnaʼtaj chke xeatinik .	X>naʼtaj ch>k>e x>e>atin>ik .
Xnaʼtaj chke xeatinik .	X>naʼtaj ch>k>e x>e>atin>ik .
Xnaʼtaj chke xeatinik .	X>naʼtaj ch>k>e x>e>atin>ik .
Xintoʼ la .	X>in>toʼ la .
Chbʼana oxibʼ tʼoytʼik che le kʼaj .	Ch>bʼan>a oxibʼ tʼoytʼik ch>e le kʼ>aj .
Xinbʼisonik taq na xatpet taj .	X>in>bʼison>ik taq na x>at>pet taj .
Ketikonik .	K>e>tiko>n>ik .
Xuyupubʼa uwach raʼchi , kachaʼ , .	X>u>yupubʼa u>wach r>aʼchi , ka>chaʼ , .
Xuyupubʼa uwach raʼchi , kachaʼ , .	X>u>yupubʼa u>wach r>aʼchi , ka>chaʼ , .
Kʼi qawinaq e kʼo pa taq pa nim tinamit .	Kʼi qa>winaq e kʼo pa taq pa nim tinamit .
Katʼisoʼmanik .	Ka>tʼisoʼm>an>ik .
T.b.g are kabʼanow chech le 98% taq yabʼil kayaʼ ubʼixik .	T.b.g are ka>bʼan>ow ch>ech le 98% taq yabʼil ka>yaʼ u>bʼixik .
Xojrilo .	X>oj>r>il>o .
Kʼax ukemik le pas awumal .	Kʼax u>kem>ik le pas aw>umal .
Kʼax ukemik le pas awumal .	Kʼax u>kem>ik le pas aw>umal .
Kʼo jun tojbʼal kinyaʼ chi awe we kachʼak ri etzʼanem .	Kʼo jun tojbʼal k>in>yaʼ chi aw>e we ka>chʼa>k ri etzʼanem .
Xinta chi katulik .	X>in>ta chi k>at>ul>ik .
Na qʼan ta uwach le qaprut .	Na qʼan ta u>wach le qa>prut .
E manxo ri jupuq kej .	E manxo ri jupuq kej .
Xsachon chke xeatinik .	X>sachon ch>k>e x>e>atin>ik .
Xsachon chke xeatinik .	X>sachon ch>k>e x>e>atin>ik .
Xsachon chke xeatinik .	X>sachon ch>k>e x>e>atin>ik .
Xinkochij ri nuwa .	X>in>kochi>j ri nu>wa .
Are taq xukʼulmaj waʼ xul ri uchomanik xubʼij : are utz wa aqʼabʼ kinwalijik , are chaʼ chanim kinopan pa tijobʼal , maj chi kinkʼulmaj .	Are taq x>u>kʼulma>j waʼ x>ul ri u>chomanik x>u>bʼij : are utz wa aqʼabʼ k>in>walij>ik , are chaʼ chanim k>in>opan pa tijobʼal , maj chi k>in>kʼulma>j .
Pa Bʼokoʼ kachakun wi ri Tax .	Pa Bʼokoʼ ka>chakun wi ri Tax .
Kʼo ri jaʼmaril pa ri qachoch .	Kʼo ri jaʼmaril pa ri q>achoch .
Xinwilo chi takʼalik xulik .	X>inw>il>o chi takʼal>ik x>ul>ik .
Amaqʼel naʼl kubʼan chech ri utijoxik ribʼ pa tijobʼal .	Amaqʼel naʼl k>u>bʼan ch>ech ri u>tijo>x>ik r>ibʼ pa tijobʼal .
Xinok pa ja .	X>in>ok pa ja .
Sibʼalaj tzʼuj rumal ri jabʼ .	Sibʼalaj tzʼuj r>umal ri jabʼ .
Qʼeqqʼoj rij ri amaʼ kej .	Qʼeqqʼoj r>ij ri amaʼ kej .
Utz we katbʼin pa ri rambʼal bʼe .	Utz we k>at>bʼin pa ri rambʼal bʼe .
Xinbʼij chi kinʼek .	X>in>bʼij chi k>in>ʼek .
Kosnaq le achi .	Kosnaq le achi .
Ri Wel kʼo pa tijonik .	Ri Wel kʼo pa tijonik .
Pa jun jeʼl tijobʼal kutijoj ribʼ jun akʼal , ubʼiʼ Poʼx , utz kurilo ke pa tijobʼal ronojel taq qʼij .	Pa jun jeʼl tijobʼal k>u>tijo>j r>ibʼ jun akʼal , u>bʼiʼ Poʼx , utz k>ur>il>o k>e pa tijobʼal r>onojel taq qʼij .
Kaqaxiʼj qibʼ kaqachapo .	Ka>qa>xiʼj q>ibʼ ka>qa>chap>o .
Xinwetaʼmaj rilik wibʼ .	X>inw>etaʼma>j r>il>ik w>ibʼ .
Nim ri unaʼoj wajtij .	Nim ri u>naʼoj w>ajtij .
Chqanukʼuʼ ri qatzij .	Ch>qa>nukʼ>uʼ ri qa>tzij .
Ri ixtzol are jun chikop kʼo chi uxeʼ ri ulew .	Ri ixtzol are jun chikop kʼo chi u>xeʼ ri ulew .
Sibʼalaj ikim at kʼo wi loq .	Sibʼalaj ikim at kʼo wi loq .
Kqʼoxow nujalom .	K>qʼoxow nu>jalom .
Jewa xkibʼano xetzalij cho kachoch rukʼ kikotemal .	Jewa x>ki>bʼan>o x>e>tzalij ch>o k>achoch r>ukʼ kikotemal .
Sibʼalaj miqʼin jelaʼ pa Kʼaqoʼl .	Sibʼalaj miqʼin jelaʼ pa Kʼaqoʼl .
Ri Max are aj qʼan iyaʼ .	Ri Max are aj qʼan iyaʼ .
Man kkaʼy taj ri qʼij .	Man k>kaʼy taj ri qʼij .
In kinbʼij na katsach taj .	In k>in>bʼij na k>at>sach taj .
In kinbʼij na katsach taj .	In k>in>bʼij na k>at>sach taj .
Xkibʼan kʼax che le uwosaq rumal man utz ta chi kakayik .	X>ki>bʼan kʼax ch>e le uwosaq r>umal man utz ta chi ka>kay>ik .
E kʼo kebʼ ukʼajol le tat Xwan .	E kʼo kebʼ u>kʼajol le tat Xwan .
Kakʼex ri axajabʼ .	Ka>kʼex ri a>xajabʼ .
Utz we nutzʼiʼ .	Utz we nu>tzʼiʼ .
Ko ri ja .	Ko ri ja .
Xinloqʼ jun ja pa ri wokaj ja .	X>in>loqʼ jun ja pa ri wokaj ja .
Amaqʼel kinnumik .	Amaqʼel k>in>num>ik .
Krapap ri kʼuch pa ri kaqiqʼ .	K>rapap ri kʼuch pa ri kaqiqʼ .
Jeʼ , xintzalijik .	Jeʼ , x>in>tzalij>ik .
We ta xatbʼe wukʼ pa le tinamit , xaloqʼ ta waʼ we jastaq .	We ta x>at>bʼe w>ukʼ pa le tinamit , x>a>loqʼ ta waʼ we jastaq .
We ta ne aʼre xetijow le rikil , are le komon xetijowik .	We ta ne aʼre x>e>tijow le rikil , are le komon x>e>tijow>ik .
Ri ukʼuʼx tzʼibʼ pa qatzij e lajuj .	Ri u>kʼuʼx tzʼibʼ pa qa>tzij e lajuj .
We katij anxux man katutoʼ ta chi uqʼatixik le kʼakʼ yabʼil coronavirus ( 2019 - nCOV ) .	We ka>tij anxux man k>at>u>toʼ ta chi u>qʼati>x>ik le kʼakʼ yabʼil coronavirus ( 2019 - nCOV ) .
Ri kʼum ktijow rukʼ kabʼ .	Ri kʼum k>tijow r>ukʼ k>abʼ .
Jas kubʼij chwe ?	Jas k>u>bʼi>j ch>w>e ?
Are chiʼ kakʼis ri junabʼ kʼo qʼinom .	Are chiʼ ka>kʼis ri junabʼ kʼo qʼinom .
Kaqilo chi na kojukʼam taj .	Ka>q>il>o chi na k>oj>u>kʼam taj .
Xkowir ri kaxlaʼn wa wa .	X>kowir ri kaxlaʼn wa wa .
Xinaxibʼij pa bʼe .	X>in>a>xibʼi>j pa bʼe .
¿ Jachin kpe nabʼe ?	¿ Jachin k>pe nabʼe ?
Ri kinaqʼ kuyaʼ qʼipip chi we .	Ri kinaqʼ k>u>yaʼ qʼipip chi w>e .
Xuchap ri bʼa ri xutij qakinaq .	X>u>chap ri bʼa ri x>u>tij qa>kinaq .
Xinbʼij iwir chi xebʼe pa Armita .	X>in>bʼij iwir chi x>e>bʼe pa Armita .
Are le nutat kinloqʼonik .	Are le nu>tat k>in>loqʼo>n>ik .
Kinbʼe taj .	K>in>bʼe taj .
Waʼ we qʼij , nim ubʼantajik .	Waʼ we qʼij , nim u>bʼantajik .
Iwech ri abʼix .	Iw>ech ri abʼix .
Ri sachibʼal mak rajwaxik chi qaxoʼl .	Ri sachibʼal mak rajwaxik chi qa>xoʼl .
Utz tajin kkanaj , ri qatzʼaq .	Utz tajin k>kanaj , ri qa>tzʼaq .
Ri rajaw rulew areʼ tat Kel .	Ri r>ajaw r>ulew areʼ tat K>el .
Xojkilo .	X>oj>k>il>o .
Le achijabʼ xeʼqʼabʼaroq .	Le achij>abʼ x>eʼ>qʼabʼar>oq .
Xataqchiʼj le akʼal chutijik kar .	X>a>taqchiʼ>j le akʼal ch>u>tij>ik kar .
Kʼatekʼuri le tat Xoʼr xubʼij , man kawaj taj , man kawaj taj .	Kʼatekʼuri le tat Xoʼr x>u>bʼij , man k>aw>aj taj , man k>aw>aj taj .
Xukunaj le yawabʼ le aj qʼij .	X>u>kuna>j le yawabʼ le aj qʼij .
Xinnaʼo chi katpetik .	X>in>naʼ>o chi k>at>pet>ik .
Le qʼor xchʼuqik .	Le qʼor x>chʼuq>ik .
Man tajin ta kinchakunik .	Man tajin ta k>in>chakun>ik .
Ri kinan xubʼij chike : - ma kixeʼ ta naj , we kixetzʼanik , xaq naqaj kixkʼojiʼ wi .	Ri ki>nan x>u>bʼij chi>k>e : - ma ki>xeʼ ta naj , we k>ix>etzʼan>ik , xaq naqaj k>ix>kʼojiʼ wi .
Ri imul xubʼij : – maltyox chawe , we kabʼan ri toqʼobʼ , chakuyuʼ kinkaʼy apan jutzʼit ajsik , xchaʼ ri imul .	Ri imul x>u>bʼij : – maltyox ch>aw>e , we k>a>bʼan ri toqʼobʼ , ch>a>kuy>uʼ k>in>kaʼy apan jutzʼit ajsik , x>chaʼ ri imul .
Areʼ xqaj loq chi uwach ri juyubʼ .	Areʼ x>qaj loq chi u>wach ri juyubʼ .
Pa ojer qʼalpul xaq xu wi ri nim winaq kekʼamow bʼe .	Pa ojer qʼalpul xaq xu wi ri nim winaq k>e>kʼamow bʼe .
Chweʼq kinkʼam nuʼloq .	Chweʼq k>in>kʼam nuʼ>loq .
We ta xanimaj jas le xinbʼij chawech , ma ta je laʼ laʼ xabʼano .	We ta x>a>nima>j jas le x>in>bʼi>j ch>aw>ech , ma ta je laʼ laʼ x>a>bʼan>o .
Kamik kewaʼ pa taq ri bʼe .	Kamik k>e>waʼ pa taq ri bʼe .
Ximbʼe rukʼ le ajkun iwir .	X>im>bʼe r>ukʼ le ajkun iwir .
Ronojel ri yaʼtalil pa we qʼataj , tzʼaqat kiwach , man ktzaq ta kanoq xuqujeʼ man ktas taj .	R>onojel ri yaʼtalil pa we qʼataj , tzʼaqat ki>wach , man k>tzaq ta kan>oq xuqujeʼ man k>tas taj .
In xinbʼe rukʼ ri wachiʼl .	In x>in>bʼe r>ukʼ ri w>achiʼl .
Awumal .	Aw>umal .
Xinqʼiʼo na xinatin taj .	X>in>qʼiʼ>o na x>in>atin taj .
Naj kʼo wi le woʼch chuwach le tijobʼal .	Naj kʼo wi le w>oʼch ch>u>wach le tijobʼal .
Naj kʼo wi le woʼch chuwach le tijobʼal .	Naj kʼo wi le w>oʼch ch>u>wach le tijobʼal .
Xinxiʼj wibʼ xinchʼawik .	X>in>xiʼj w>ibʼ x>in>chʼaw>ik .
Kʼax ri upam ri Juʼl .	Kʼax ri u>pam ri Juʼl .
Paqal rajil le pix kamik .	Paqal rajil le pix kamik .
Rutzil wachaj .	R>utzil wach>aj .
Kutij qʼayes ri ixpaʼch .	K>u>tij qʼayes ri ixpaʼch .
Are kel wajxaqibʼ uqʼij ri xkʼojik .	Are k>el wajxaqibʼ u>qʼij ri x>kʼoji>k .
Teʼk Ixchobʼ ubʼiʼ ri nutat .	Teʼk Ixchobʼ u>bʼiʼ ri nu>tat .
Kʼo iwabʼ ix pa juyubʼ .	Kʼo iw>abʼ ix pa juyubʼ .
Na nukʼamom tuʼla riʼ .	Na nu>kʼam>om tuʼ>la riʼ .
Ri achi xkanaj tzoqʼ .	Ri achi x>kanaj tzoqʼ .
Te kʼu riʼ xutzʼibʼaj ribʼ pa ri nimalaj tijobʼal rech Ajkuʼn .	Te kʼu riʼ x>u>tzʼibʼa>j r>ibʼ pa ri nim>alaj tijobʼal r>ech Ajkuʼn .
Kʼo jumul jun achi qʼinom , xuchomaj kbʼe che jun waʼkatem , xuyaʼ kanoq ri qʼan taq pwaq rukʼ jun ukʼul ja , are chiʼ xtzalij uloq che le uwakatem .	Kʼo jumul jun achi qʼinom , x>u>chomaj k>bʼe ch>e jun waʼkatem , x>u>yaʼ kan>oq ri qʼan taq pwaq r>ukʼ jun u>kʼul ja , are chiʼ x>tzalij uloq ch>e le u>wakatem .
Xinwetaʼmaj chi na katpe taj .	X>inw>etaʼma>j chi na k>at>pe taj .
Xinwetaʼmaj chi na katpe taj .	X>inw>etaʼma>j chi na k>at>pe taj .
Xkʼis kanoq ri qachak .	X>kʼis kan>oq ri qa>chak .
Ri nimaʼq taq winaq kʼo ketaʼmabʼal .	Ri nim>aʼq taq winaq kʼo k>etaʼmabʼal .
Ri alaj taq akʼalabʼ jeʼl kkinaʼ etzʼanem kukʼ ri pepe .	Ri alaj taq akʼal>abʼ jeʼl k>ki>naʼ etzʼanem k>ukʼ ri pepe .
Ri la sibʼalaj utz che kunabʼal .	Ri la sibʼalaj utz ch>e kunabʼal .
Ri a Xtuʼbʼ , kʼo qulaj chech .	Ri a Xtuʼbʼ , kʼo qulaj ch>ech .
E kʼo ixoqibʼ pa le kʼaybʼal .	E kʼo ixoq>ibʼ pa le kʼaybʼal .
Kinxikʼikʼik xinqʼaxik .	K>in>xikʼikʼ>ik x>in>qʼax>ik .
Kqabʼij man kekowin taj .	K>qa>bʼij man k>e>kowin taj .
Man kʼo ta ucholaj pa taq ri awuj .	Man kʼo ta u>cholaj pa taq ri a>wuj .
Xkitzijoj chikech ri winaq man utz taj keqasax ri cheʼ , we kabʼanik , kasikʼix saqʼij chaqij .	X>ki>tzijo>j chi>k>ech ri winaq man utz taj k>e>qasa>x ri cheʼ , we ka>bʼan>ik , ka>sikʼix saqʼij chaqij .
Jun laj neʼ kʼo chupam .	Jun laj neʼ kʼo ch>u>pam .
Ri unan e ri erachalal kepe uloq rukʼ ri areʼ , kʼatekʼuriʼ , man kekowin taj keqibʼ ukoq rukʼ , rumal rech che ekʼo sibʼalaj winaq .	Ri u>nan e ri e>r>achalal k>e>pe uloq r>ukʼ ri areʼ , kʼatekʼuriʼ , man k>e>kowin taj k>e>qibʼ uk>oq r>ukʼ , r>umal r>ech ch>e e>kʼo sibʼalaj winaq .
Xineʼwaʼoq .	X>in>eʼ>waʼ>oq .
Xineʼwaʼoq .	X>in>eʼ>waʼ>oq .
¿ Kʼo kʼu laʼ jun kunabʼal che kuqʼatej xuqujeʼ kukunaj le kʼakʼ yabʼil coronavirus ?	¿ Kʼo kʼu laʼ jun kunabʼal ch>e k>u>qʼatej xuqujeʼ k>u>kunaj le kʼakʼ yabʼil coronavirus ?
La xatwaʼ kʼut ?	La x>at>waʼ kʼut ?
Kakimulij jusin kifondo rech kakichapobʼej .	Ka>ki>muli>j ju>sin ki>fondo r>ech ka>ki>chapobʼe>j .
Kʼisbʼal kanoq , xoqujeʼ kkam ri ixoq .	Kʼisbʼal kan>oq , xoqujeʼ k>kam ri ixoq .
Xinpaj ri nutriko .	X>in>paj ri nu>triko .
Xekʼam chuʼbʼi le akʼalabʼ .	X>e>kʼam chuʼ>bʼi le akʼal>abʼ .
Xinwilo chi xwaʼik .	X>inw>il>o chi x>waʼ>ik .
Jachin xtzaqow rech ?	Jachin x>tzaq>ow r>ech ?
Sibʼalaj chʼuʼj ri a Max .	Sibʼalaj chʼuʼj ri a Max .
Chaʼtal ri ijaʼ xqatik iwir .	Chaʼtal ri i>jaʼ x>qat>ik iwir .
Ri ajtikonel kutik ri Tzij .	Ri ajtikonel k>u>tik ri Tzij .
La kaj la kojbʼeʼ pa le chomal chweʼq ?	La k>>aj la k>oj>bʼeʼ pa le chomal chweʼq ?
Sibʼalaj kʼax ri xkʼulmaxik .	Sibʼalaj kʼax ri x>kʼulma>x>ik .
Xetzalij bʼi kukʼ le awaj rukʼ kikotemal .	X>e>tzalij bʼi k>ukʼ le awaj r>ukʼ kikotemal .
Kinkowinik kinkʼam bʼi le pwaq .	K>in>kowin>ik k>in>kʼam bʼi le pwaq .
Kmatzatz kbʼin ri alaj tzʼiʼ .	K>matzatz k>bʼin ri alaj tzʼiʼ .
E nimaʼq le altomabʼ .	E nim>aʼq le altom>abʼ .
Kʼo pomaj che ri alaj akʼal .	Kʼo pomaj ch>e ri alaj akʼal .
Nim ri kʼayibʼal pa ri tinamit Chi Uwi Miqʼin Jaʼ .	Nim ri kʼayibʼal pa ri tinamit Chi U>wi Miqʼin Jaʼ .
Ulejik wa tajin kuʼano .	U>lej>ik wa tajin k>u>ʼan>o .
Rajawxik kpaqʼ ronojel ri cheʼ .	Rajawxik k>paqʼ r>onojel ri cheʼ .
Sibʼalaj utz winaq ri Kel .	Sibʼalaj utz winaq ri K>el .
Ketzʼan ri alaj ali rukʼ ri alaʼs .	K>etzʼan ri alaj ali r>ukʼ ri alaʼs .
Jas le ukʼexbʼem ribʼ le jun rukʼ le jun chik ?	Jas le u>kʼexbʼem r>ibʼ le jun r>ukʼ le jun chik ?
We kinkosik kinwarik .	We k>in>kos>ik k>in>war>ik .
Tajin kqakʼot jun jul .	Tajin k>qa>kʼot jun jul .
Tajin kel ukikʼel pa raqan ri tzʼiʼ .	Tajin k>el u>kikʼel pa r>aqan ri tzʼiʼ .
Are taq waʼ ri uqʼijol we taqanik .	Are taq waʼ ri u>qʼijol we taqanik .
At rajkun le nunan .	At r>ajkun le nu>nan .
In waʼ we kinyʼow le tzijonem .	In waʼ we k>in>yʼ>ow le tzijonem .
Kʼo jun ala pa tijobʼal .	Kʼo jun ala pa tijobʼal .
Xinwil le ala .	X>inw>il le ala .
Kinkʼam nuʼbʼi chweʼq .	K>in>kʼam nuʼ>bʼi chweʼq .
Chinakuyuʼ che we jupaj tzij .	Ch>in>a>kuy>uʼ ch>e we jupaj tzij .
Kajuluw ri chʼumil chaqʼabʼ .	Ka>juluw ri chʼumil chaqʼabʼ .
Iwir xintzalij uloq .	Iwir x>in>tzalij uloq .
Ajxik chʼichʼ ri Luʼs .	Ajxik chʼichʼ ri Luʼs .
Xumajij roqʼexik uwach le unan le ali .	X>u>maji>j r>oqʼe>x>ik u>wach le u>nan le ali .
Xuʼlukʼamaʼ .	X>uʼl>u>kʼam>aʼ .
Kaqoyʼej na kixpe taj .	Ka>q>oyʼe>j na k>ix>pe taj .
Kʼax ri wanimaʼ .	Kʼax ri w>animaʼ .
Xqʼatan ri par .	X>qʼatan ri par .
Sibʼalaj jeʼlik ri uwaʼl ri ichaj .	Sibʼalaj jeʼl>ik ri u>waʼl ri ichaj .
Ri sin kkʼiy pa taqʼaj .	Ri sin k>kʼiy pa taqʼaj .
Ri al Ixchel , kuchomaj chi ri unan , jun akʼ xuloqʼ uloq .	Ri al Ixchel , k>u>choma>j chi ri u>nan , jun akʼ x>ul>oqʼ uloq .
Pero noʼjimal petnaq loq , .	Pero noʼjimal pet>naq loq , .
E kebʼ kekʼam bʼik pa tuj .	E kebʼ k>e>kʼam bʼi>k pa tuj .
Kʼo cheʼ pa le kʼachelaʼj .	Kʼo cheʼ pa le kʼachelaʼj .
Xax rij mansaʼn .	Xax r>ij mansaʼn .
Man kʼo ta pwaq chech ri umuqubʼal .	Man kʼo ta pwaq ch>ech ri u>muqubʼal .
Rajawaxik kakʼaman chawe le utijik le lej .	Rajawaxik ka>kʼaman ch>aw>e le u>tij>ik le lej .
Sipojinaq ri nupam .	Sipojinaq ri nu>pam .
Xinbʼe .	X>in>bʼe .
